subject,video,type,type_idx,startFrame,endFrame,frame_num,length
001,/home/yww/CAS^3/new_data_full_reduce/001/a,Macro,1,31,59,836,28
001,/home/yww/CAS^3/new_data_full_reduce/001/a,Macro,1,262,302,836,40
001,/home/yww/CAS^3/new_data_full_reduce/001/a,Macro,1,590,618,836,28
001,/home/yww/CAS^3/new_data_full_reduce/001/a,Micro,2,349,354,836,5
001,/home/yww/CAS^3/new_data_full_reduce/001/b,Micro,2,160,173,878,13
001,/home/yww/CAS^3/new_data_full_reduce/001/d,Macro,1,217,243,4070,26
001,/home/yww/CAS^3/new_data_full_reduce/001/d,Macro,1,244,266,4070,22
001,/home/yww/CAS^3/new_data_full_reduce/001/d,Macro,1,298,373,4070,75
001,/home/yww/CAS^3/new_data_full_reduce/001/e,Micro,2,92,102,2294,10
001,/home/yww/CAS^3/new_data_full_reduce/001/f,Micro,2,1564,1577,1853,13
001,/home/yww/CAS^3/new_data_full_reduce/001/h,Micro,2,177,190,2719,13
001,/home/yww/CAS^3/new_data_full_reduce/001/j,Macro,1,46,93,1999,47
001,/home/yww/CAS^3/new_data_full_reduce/001/j,Macro,1,349,398,1999,49
001,/home/yww/CAS^3/new_data_full_reduce/001/j,Micro,2,96,107,1999,11
001,/home/yww/CAS^3/new_data_full_reduce/001/k,Macro,1,58,79,1948,21
001,/home/yww/CAS^3/new_data_full_reduce/001/k,Macro,1,80,125,1948,45
001,/home/yww/CAS^3/new_data_full_reduce/001/k,Macro,1,1871,1887,1948,16
001,/home/yww/CAS^3/new_data_full_reduce/001/k,Micro,2,147,162,1948,15
001,/home/yww/CAS^3/new_data_full_reduce/001/m,Macro,1,164,219,2371,55
002,/home/yww/CAS^3/new_data_full_reduce/002/a,Macro,1,786,842,847,56
002,/home/yww/CAS^3/new_data_full_reduce/002/b,Macro,1,773,822,995,49
002,/home/yww/CAS^3/new_data_full_reduce/002/c,Macro,1,453,567,2806,114
002,/home/yww/CAS^3/new_data_full_reduce/002/c,Macro,1,784,888,2806,104
002,/home/yww/CAS^3/new_data_full_reduce/002/c,Macro,1,2542,2581,2806,39
002,/home/yww/CAS^3/new_data_full_reduce/002/d,Macro,1,616,669,3699,53
002,/home/yww/CAS^3/new_data_full_reduce/002/d,Macro,1,669,729,3699,60
002,/home/yww/CAS^3/new_data_full_reduce/002/d,Macro,1,729,762,3699,33
002,/home/yww/CAS^3/new_data_full_reduce/002/d,Macro,1,1190,1241,3699,51
002,/home/yww/CAS^3/new_data_full_reduce/002/d,Macro,1,1288,1398,3699,110
002,/home/yww/CAS^3/new_data_full_reduce/002/d,Macro,1,1398,1473,3699,75
002,/home/yww/CAS^3/new_data_full_reduce/002/d,Macro,1,1691,1751,3699,60
002,/home/yww/CAS^3/new_data_full_reduce/002/d,Macro,1,1800,1852,3699,52
002,/home/yww/CAS^3/new_data_full_reduce/002/d,Macro,1,1872,1946,3699,74
002,/home/yww/CAS^3/new_data_full_reduce/002/d,Macro,1,2154,2199,3699,45
002,/home/yww/CAS^3/new_data_full_reduce/002/d,Macro,1,2262,2349,3699,87
002,/home/yww/CAS^3/new_data_full_reduce/002/d,Macro,1,2370,2418,3699,48
002,/home/yww/CAS^3/new_data_full_reduce/002/d,Macro,1,2443,2511,3699,68
002,/home/yww/CAS^3/new_data_full_reduce/002/d,Macro,1,2547,2595,3699,48
002,/home/yww/CAS^3/new_data_full_reduce/002/d,Macro,1,2629,2688,3699,59
002,/home/yww/CAS^3/new_data_full_reduce/002/d,Macro,1,2721,2773,3699,52
002,/home/yww/CAS^3/new_data_full_reduce/002/d,Macro,1,2906,2979,3699,73
002,/home/yww/CAS^3/new_data_full_reduce/002/e,Macro,1,954,1027,2644,73
002,/home/yww/CAS^3/new_data_full_reduce/002/e,Micro,2,134,144,2644,10
002,/home/yww/CAS^3/new_data_full_reduce/002/f,Macro,1,617,649,1916,32
002,/home/yww/CAS^3/new_data_full_reduce/002/f,Macro,1,1044,1078,1916,34
002,/home/yww/CAS^3/new_data_full_reduce/002/f,Macro,1,1156,1210,1916,54
002,/home/yww/CAS^3/new_data_full_reduce/002/f,Macro,1,1392,1466,1916,74
002,/home/yww/CAS^3/new_data_full_reduce/002/g,Macro,1,1051,1124,2024,73
002,/home/yww/CAS^3/new_data_full_reduce/002/g,Macro,1,1438,1498,2024,60
002,/home/yww/CAS^3/new_data_full_reduce/002/h,Macro,1,1051,1121,2823,70
002,/home/yww/CAS^3/new_data_full_reduce/002/i,Macro,1,869,927,3103,58
002,/home/yww/CAS^3/new_data_full_reduce/002/i,Macro,1,1569,1620,3103,51
002,/home/yww/CAS^3/new_data_full_reduce/002/i,Macro,1,1904,1975,3103,71
002,/home/yww/CAS^3/new_data_full_reduce/002/i,Macro,1,2281,2354,3103,73
002,/home/yww/CAS^3/new_data_full_reduce/002/i,Macro,1,2550,2593,3103,43
002,/home/yww/CAS^3/new_data_full_reduce/002/j,Macro,1,643,744,1578,101
002,/home/yww/CAS^3/new_data_full_reduce/002/k,Macro,1,97,123,2213,26
002,/home/yww/CAS^3/new_data_full_reduce/002/k,Macro,1,2039,2067,2213,28
002,/home/yww/CAS^3/new_data_full_reduce/002/k,Micro,2,179,194,2213,15
002,/home/yww/CAS^3/new_data_full_reduce/002/l,Macro,1,460,518,3416,58
002,/home/yww/CAS^3/new_data_full_reduce/002/l,Macro,1,1200,1240,3416,40
002,/home/yww/CAS^3/new_data_full_reduce/002/l,Macro,1,1377,1463,3416,86
002,/home/yww/CAS^3/new_data_full_reduce/002/l,Macro,1,1944,1986,3416,42
002,/home/yww/CAS^3/new_data_full_reduce/002/l,Macro,1,2715,2800,3416,85
002,/home/yww/CAS^3/new_data_full_reduce/002/l,Macro,1,2805,2916,3416,111
002,/home/yww/CAS^3/new_data_full_reduce/002/m,Macro,1,45,64,2219,19
002,/home/yww/CAS^3/new_data_full_reduce/002/m,Macro,1,1103,1173,2219,70
002,/home/yww/CAS^3/new_data_full_reduce/002/m,Macro,1,1766,1798,2219,32
002,/home/yww/CAS^3/new_data_full_reduce/002/m,Macro,1,1805,1858,2219,53
003,/home/yww/CAS^3/new_data_full_reduce/003/c,Macro,1,1300,1362,2735,62
003,/home/yww/CAS^3/new_data_full_reduce/003/c,Macro,1,1629,1692,2735,63
003,/home/yww/CAS^3/new_data_full_reduce/003/c,Macro,1,1840,1922,2735,82
003,/home/yww/CAS^3/new_data_full_reduce/003/c,Macro,1,1959,2030,2735,71
003,/home/yww/CAS^3/new_data_full_reduce/003/c,Macro,1,2347,2389,2735,42
003,/home/yww/CAS^3/new_data_full_reduce/003/d,Macro,1,138,190,3814,52
003,/home/yww/CAS^3/new_data_full_reduce/003/d,Macro,1,452,532,3814,80
003,/home/yww/CAS^3/new_data_full_reduce/003/e,Macro,1,1381,1470,2541,89
003,/home/yww/CAS^3/new_data_full_reduce/003/g,Macro,1,79,118,2158,39
003,/home/yww/CAS^3/new_data_full_reduce/003/g,Macro,1,223,281,2158,58
003,/home/yww/CAS^3/new_data_full_reduce/003/g,Macro,1,775,844,2158,69
003,/home/yww/CAS^3/new_data_full_reduce/003/g,Macro,1,1043,1121,2158,78
003,/home/yww/CAS^3/new_data_full_reduce/003/g,Macro,1,1367,1398,2158,31
003,/home/yww/CAS^3/new_data_full_reduce/003/g,Macro,1,1626,1704,2158,78
003,/home/yww/CAS^3/new_data_full_reduce/003/h,Macro,1,100,127,2797,27
003,/home/yww/CAS^3/new_data_full_reduce/003/h,Macro,1,748,775,2797,27
003,/home/yww/CAS^3/new_data_full_reduce/003/h,Macro,1,1584,1642,2797,58
003,/home/yww/CAS^3/new_data_full_reduce/003/h,Macro,1,1729,1762,2797,33
003,/home/yww/CAS^3/new_data_full_reduce/003/h,Macro,1,1877,1928,2797,51
003,/home/yww/CAS^3/new_data_full_reduce/003/h,Macro,1,1974,2054,2797,80
003,/home/yww/CAS^3/new_data_full_reduce/003/h,Macro,1,2065,2092,2797,27
003,/home/yww/CAS^3/new_data_full_reduce/003/i,Macro,1,155,251,3400,96
003,/home/yww/CAS^3/new_data_full_reduce/003/i,Macro,1,2390,2430,3400,40
003,/home/yww/CAS^3/new_data_full_reduce/003/k,Macro,1,46,99,2250,53
003,/home/yww/CAS^3/new_data_full_reduce/003/l,Macro,1,64,123,3465,59
003,/home/yww/CAS^3/new_data_full_reduce/003/l,Macro,1,1532,1577,3465,45
003,/home/yww/CAS^3/new_data_full_reduce/003/l,Macro,1,1959,2022,3465,63
003,/home/yww/CAS^3/new_data_full_reduce/003/l,Macro,1,2460,2556,3465,96
003,/home/yww/CAS^3/new_data_full_reduce/003/l,Macro,1,2735,2813,3465,78
003,/home/yww/CAS^3/new_data_full_reduce/003/l,Macro,1,2867,2921,3465,54
003,/home/yww/CAS^3/new_data_full_reduce/003/m,Macro,1,899,978,2280,79
003,/home/yww/CAS^3/new_data_full_reduce/003/m,Macro,1,1405,1466,2280,61
003,/home/yww/CAS^3/new_data_full_reduce/003/m,Micro,2,1534,1545,2280,11
004,/home/yww/CAS^3/new_data_full_reduce/004/a,Macro,1,47,148,838,101
004,/home/yww/CAS^3/new_data_full_reduce/004/a,Macro,1,345,388,838,43
004,/home/yww/CAS^3/new_data_full_reduce/004/a,Macro,1,428,523,838,95
004,/home/yww/CAS^3/new_data_full_reduce/004/b,Macro,1,578,640,969,62
004,/home/yww/CAS^3/new_data_full_reduce/004/b,Macro,1,679,767,969,88
004,/home/yww/CAS^3/new_data_full_reduce/004/e,Macro,1,23,66,2287,43
004,/home/yww/CAS^3/new_data_full_reduce/004/f,Macro,1,1,55,1907,54
004,/home/yww/CAS^3/new_data_full_reduce/004/f,Macro,1,55,110,1907,55
004,/home/yww/CAS^3/new_data_full_reduce/004/f,Macro,1,1691,1805,1907,114
004,/home/yww/CAS^3/new_data_full_reduce/004/g,Macro,1,1530,1605,2058,75
004,/home/yww/CAS^3/new_data_full_reduce/004/g,Macro,1,1923,1998,2058,75
004,/home/yww/CAS^3/new_data_full_reduce/004/g,Micro,2,2029,2037,2058,8
004,/home/yww/CAS^3/new_data_full_reduce/004/h,Macro,1,11,34,2782,23
004,/home/yww/CAS^3/new_data_full_reduce/004/h,Macro,1,492,603,2782,111
004,/home/yww/CAS^3/new_data_full_reduce/004/k,Macro,1,314,420,2193,106
004,/home/yww/CAS^3/new_data_full_reduce/004/k,Macro,1,2069,2115,2193,46
004,/home/yww/CAS^3/new_data_full_reduce/004/l,Macro,1,1799,1827,3356,28
005,/home/yww/CAS^3/new_data_full_reduce/005/c,Micro,2,480,493,2818,13
005,/home/yww/CAS^3/new_data_full_reduce/005/e,Macro,1,80,139,2439,59
005,/home/yww/CAS^3/new_data_full_reduce/005/e,Micro,2,1915,1927,2439,12
005,/home/yww/CAS^3/new_data_full_reduce/005/j,Macro,1,659,689,1527,30
006,/home/yww/CAS^3/new_data_full_reduce/006/a,Macro,1,30,111,843,81
006,/home/yww/CAS^3/new_data_full_reduce/006/c,Macro,1,2001,2041,2900,40
006,/home/yww/CAS^3/new_data_full_reduce/006/c,Micro,2,240,246,2900,6
006,/home/yww/CAS^3/new_data_full_reduce/006/e,Macro,1,2,35,2445,33
006,/home/yww/CAS^3/new_data_full_reduce/006/h,Macro,1,63,111,2667,48
006,/home/yww/CAS^3/new_data_full_reduce/006/h,Macro,1,644,702,2667,58
006,/home/yww/CAS^3/new_data_full_reduce/006/i,Macro,1,2103,2172,3542,69
006,/home/yww/CAS^3/new_data_full_reduce/006/i,Macro,1,3375,3479,3542,104
006,/home/yww/CAS^3/new_data_full_reduce/006/j,Macro,1,1332,1395,1690,63
006,/home/yww/CAS^3/new_data_full_reduce/006/j,Micro,2,1679,1688,1690,9
006,/home/yww/CAS^3/new_data_full_reduce/006/l,Macro,1,819,836,3285,17
007,/home/yww/CAS^3/new_data_full_reduce/007/a,Micro,2,34,48,816,14
007,/home/yww/CAS^3/new_data_full_reduce/007/b,Macro,1,416,520,1047,104
007,/home/yww/CAS^3/new_data_full_reduce/007/b,Macro,1,828,912,1047,84
007,/home/yww/CAS^3/new_data_full_reduce/007/c,Macro,1,81,100,2812,19
007,/home/yww/CAS^3/new_data_full_reduce/007/c,Macro,1,204,236,2812,32
007,/home/yww/CAS^3/new_data_full_reduce/007/c,Macro,1,378,402,2812,24
007,/home/yww/CAS^3/new_data_full_reduce/007/d,Macro,1,573,632,4003,59
007,/home/yww/CAS^3/new_data_full_reduce/007/k,Macro,1,1942,1974,2289,32
008,/home/yww/CAS^3/new_data_full_reduce/008/b,Macro,1,141,187,971,46
008,/home/yww/CAS^3/new_data_full_reduce/008/b,Macro,1,298,358,971,60
008,/home/yww/CAS^3/new_data_full_reduce/008/d,Macro,1,1,42,3721,41
008,/home/yww/CAS^3/new_data_full_reduce/008/d,Macro,1,175,259,3721,84
008,/home/yww/CAS^3/new_data_full_reduce/008/d,Macro,1,487,528,3721,41
008,/home/yww/CAS^3/new_data_full_reduce/008/e,Macro,1,57,99,2499,42
008,/home/yww/CAS^3/new_data_full_reduce/008/e,Macro,1,625,696,2499,71
008,/home/yww/CAS^3/new_data_full_reduce/008/e,Macro,1,1773,1853,2499,80
008,/home/yww/CAS^3/new_data_full_reduce/008/e,Macro,1,2020,2126,2499,106
008,/home/yww/CAS^3/new_data_full_reduce/008/e,Macro,1,2179,2224,2499,45
008,/home/yww/CAS^3/new_data_full_reduce/008/e,Micro,2,291,304,2499,13
008,/home/yww/CAS^3/new_data_full_reduce/008/f,Macro,1,3,65,1887,62
008,/home/yww/CAS^3/new_data_full_reduce/008/f,Macro,1,289,403,1887,114
008,/home/yww/CAS^3/new_data_full_reduce/008/f,Macro,1,949,1026,1887,77
008,/home/yww/CAS^3/new_data_full_reduce/008/f,Macro,1,1573,1614,1887,41
008,/home/yww/CAS^3/new_data_full_reduce/008/g,Macro,1,1623,1700,1913,77
008,/home/yww/CAS^3/new_data_full_reduce/008/h,Macro,1,1113,1148,2673,35
008,/home/yww/CAS^3/new_data_full_reduce/008/h,Macro,1,1279,1314,2673,35
008,/home/yww/CAS^3/new_data_full_reduce/008/h,Macro,1,1392,1429,2673,37
008,/home/yww/CAS^3/new_data_full_reduce/008/h,Macro,1,1761,1803,2673,42
008,/home/yww/CAS^3/new_data_full_reduce/008/h,Macro,1,1969,2015,2673,46
008,/home/yww/CAS^3/new_data_full_reduce/008/h,Macro,1,2095,2111,2673,16
008,/home/yww/CAS^3/new_data_full_reduce/008/h,Macro,1,2251,2310,2673,59
008,/home/yww/CAS^3/new_data_full_reduce/008/i,Macro,1,115,232,3291,117
008,/home/yww/CAS^3/new_data_full_reduce/008/i,Macro,1,476,539,3291,63
008,/home/yww/CAS^3/new_data_full_reduce/008/i,Macro,1,1223,1278,3291,55
008,/home/yww/CAS^3/new_data_full_reduce/008/i,Macro,1,1956,1998,3291,42
008,/home/yww/CAS^3/new_data_full_reduce/008/k,Macro,1,1584,1679,2165,95
008,/home/yww/CAS^3/new_data_full_reduce/008/l,Macro,1,276,389,3394,113
008,/home/yww/CAS^3/new_data_full_reduce/008/l,Macro,1,1619,1649,3394,30
008,/home/yww/CAS^3/new_data_full_reduce/008/l,Macro,1,1748,1799,3394,51
008,/home/yww/CAS^3/new_data_full_reduce/008/l,Macro,1,2429,2487,3394,58
008,/home/yww/CAS^3/new_data_full_reduce/008/l,Macro,1,2575,2654,3394,79
008,/home/yww/CAS^3/new_data_full_reduce/008/l,Micro,2,2143,2158,3394,15
008,/home/yww/CAS^3/new_data_full_reduce/008/m,Macro,1,492,536,2460,44
009,/home/yww/CAS^3/new_data_full_reduce/009/h,Micro,2,1,15,2923,14
009,/home/yww/CAS^3/new_data_full_reduce/009/j,Macro,1,726,760,1476,34
010,/home/yww/CAS^3/new_data_full_reduce/010/a,Macro,1,55,111,774,56
010,/home/yww/CAS^3/new_data_full_reduce/010/a,Macro,1,284,367,774,83
010,/home/yww/CAS^3/new_data_full_reduce/010/a,Micro,2,110,119,774,9
010,/home/yww/CAS^3/new_data_full_reduce/010/c,Macro,1,2535,2564,2844,29
010,/home/yww/CAS^3/new_data_full_reduce/010/d,Macro,1,67,122,3979,55
010,/home/yww/CAS^3/new_data_full_reduce/010/d,Micro,2,158,161,3979,3
010,/home/yww/CAS^3/new_data_full_reduce/010/d,Micro,2,687,699,3979,12
010,/home/yww/CAS^3/new_data_full_reduce/010/f,Micro,2,272,274,1901,2
010,/home/yww/CAS^3/new_data_full_reduce/010/f,Micro,2,274,279,1901,5
010,/home/yww/CAS^3/new_data_full_reduce/010/i,Macro,1,722,749,2933,27
010,/home/yww/CAS^3/new_data_full_reduce/010/i,Micro,2,2855,2865,2933,10
010,/home/yww/CAS^3/new_data_full_reduce/010/j,Micro,2,1342,1350,1635,8
010,/home/yww/CAS^3/new_data_full_reduce/010/k,Micro,2,729,737,2242,8
010,/home/yww/CAS^3/new_data_full_reduce/010/k,Micro,2,2061,2066,2242,5
010,/home/yww/CAS^3/new_data_full_reduce/010/l,Macro,1,20,69,3326,49
010,/home/yww/CAS^3/new_data_full_reduce/010/l,Macro,1,213,265,3326,52
010,/home/yww/CAS^3/new_data_full_reduce/010/l,Micro,2,1,8,3326,7
010,/home/yww/CAS^3/new_data_full_reduce/010/l,Micro,2,1086,1094,3326,8
011,/home/yww/CAS^3/new_data_full_reduce/011/a,Macro,1,312,416,917,104
011,/home/yww/CAS^3/new_data_full_reduce/011/a,Macro,1,412,455,917,43
011,/home/yww/CAS^3/new_data_full_reduce/011/a,Macro,1,440,479,917,39
011,/home/yww/CAS^3/new_data_full_reduce/011/a,Macro,1,456,479,917,23
011,/home/yww/CAS^3/new_data_full_reduce/011/a,Macro,1,736,770,917,34
011,/home/yww/CAS^3/new_data_full_reduce/011/a,Micro,2,2,16,917,14
011,/home/yww/CAS^3/new_data_full_reduce/011/a,Micro,2,20,31,917,11
011,/home/yww/CAS^3/new_data_full_reduce/011/a,Micro,2,199,206,917,7
011,/home/yww/CAS^3/new_data_full_reduce/011/a,Micro,2,251,262,917,11
011,/home/yww/CAS^3/new_data_full_reduce/011/a,Micro,2,407,412,917,5
011,/home/yww/CAS^3/new_data_full_reduce/011/c,Macro,1,874,893,2646,19
011,/home/yww/CAS^3/new_data_full_reduce/011/d,Macro,1,17,67,3649,50
011,/home/yww/CAS^3/new_data_full_reduce/011/d,Macro,1,524,626,3649,102
011,/home/yww/CAS^3/new_data_full_reduce/011/d,Macro,1,628,691,3649,63
011,/home/yww/CAS^3/new_data_full_reduce/011/d,Macro,1,1777,1800,3649,23
011,/home/yww/CAS^3/new_data_full_reduce/011/d,Macro,1,2185,2301,3649,116
011,/home/yww/CAS^3/new_data_full_reduce/011/d,Macro,1,2519,2538,3649,19
011,/home/yww/CAS^3/new_data_full_reduce/011/d,Macro,1,3627,3647,3649,20
011,/home/yww/CAS^3/new_data_full_reduce/011/d,Micro,2,1980,1988,3649,8
011,/home/yww/CAS^3/new_data_full_reduce/011/e,Macro,1,18,63,2514,45
011,/home/yww/CAS^3/new_data_full_reduce/011/e,Macro,1,1027,1064,2514,37
011,/home/yww/CAS^3/new_data_full_reduce/011/e,Macro,1,1314,1356,2514,42
011,/home/yww/CAS^3/new_data_full_reduce/011/f,Macro,1,397,417,1864,20
011,/home/yww/CAS^3/new_data_full_reduce/011/f,Macro,1,1291,1327,1864,36
011,/home/yww/CAS^3/new_data_full_reduce/011/f,Macro,1,1539,1556,1864,17
011,/home/yww/CAS^3/new_data_full_reduce/011/g,Macro,1,27,50,2159,23
011,/home/yww/CAS^3/new_data_full_reduce/011/g,Macro,1,247,286,2159,39
011,/home/yww/CAS^3/new_data_full_reduce/011/g,Macro,1,1882,1940,2159,58
011,/home/yww/CAS^3/new_data_full_reduce/011/g,Macro,1,2037,2056,2159,19
011,/home/yww/CAS^3/new_data_full_reduce/011/g,Macro,1,2129,2158,2159,29
011,/home/yww/CAS^3/new_data_full_reduce/011/h,Macro,1,159,179,2610,20
011,/home/yww/CAS^3/new_data_full_reduce/011/h,Macro,1,512,539,2610,27
011,/home/yww/CAS^3/new_data_full_reduce/011/h,Macro,1,1076,1096,2610,20
011,/home/yww/CAS^3/new_data_full_reduce/011/h,Macro,1,1827,1894,2610,67
011,/home/yww/CAS^3/new_data_full_reduce/011/h,Macro,1,2303,2348,2610,45
011,/home/yww/CAS^3/new_data_full_reduce/011/i,Macro,1,1521,1596,3647,75
011,/home/yww/CAS^3/new_data_full_reduce/011/i,Macro,1,2007,2078,3647,71
011,/home/yww/CAS^3/new_data_full_reduce/011/i,Macro,1,2084,2129,3647,45
011,/home/yww/CAS^3/new_data_full_reduce/011/i,Macro,1,2215,2297,3647,82
011,/home/yww/CAS^3/new_data_full_reduce/011/i,Macro,1,2753,2772,3647,19
011,/home/yww/CAS^3/new_data_full_reduce/011/i,Macro,1,3032,3116,3647,84
011,/home/yww/CAS^3/new_data_full_reduce/011/i,Micro,2,797,811,3647,14
011,/home/yww/CAS^3/new_data_full_reduce/011/j,Macro,1,16,52,1657,36
011,/home/yww/CAS^3/new_data_full_reduce/011/k,Macro,1,69,106,2330,37
011,/home/yww/CAS^3/new_data_full_reduce/011/k,Macro,1,382,420,2330,38
011,/home/yww/CAS^3/new_data_full_reduce/011/k,Macro,1,550,578,2330,28
011,/home/yww/CAS^3/new_data_full_reduce/011/k,Macro,1,1525,1566,2330,41
011,/home/yww/CAS^3/new_data_full_reduce/011/k,Macro,1,1621,1652,2330,31
011,/home/yww/CAS^3/new_data_full_reduce/011/k,Macro,1,2215,2246,2330,31
011,/home/yww/CAS^3/new_data_full_reduce/011/k,Micro,2,369,382,2330,13
011,/home/yww/CAS^3/new_data_full_reduce/011/k,Micro,2,1737,1741,2330,4
011,/home/yww/CAS^3/new_data_full_reduce/011/l,Macro,1,598,687,3221,89
011,/home/yww/CAS^3/new_data_full_reduce/011/l,Macro,1,790,815,3221,25
011,/home/yww/CAS^3/new_data_full_reduce/011/l,Micro,2,2730,2743,3221,13
011,/home/yww/CAS^3/new_data_full_reduce/011/m,Macro,1,725,832,2391,107
011,/home/yww/CAS^3/new_data_full_reduce/011/m,Macro,1,1774,1796,2391,22
011,/home/yww/CAS^3/new_data_full_reduce/011/m,Micro,2,1846,1861,2391,15
011,/home/yww/CAS^3/new_data_full_reduce/011/m,Micro,2,2231,2246,2391,15
012,/home/yww/CAS^3/new_data_full_reduce/012/a,Micro,2,316,330,748,14
012,/home/yww/CAS^3/new_data_full_reduce/012/c,Macro,1,14,109,2627,95
012,/home/yww/CAS^3/new_data_full_reduce/012/c,Macro,1,361,469,2627,108
012,/home/yww/CAS^3/new_data_full_reduce/012/c,Macro,1,400,485,2627,85
012,/home/yww/CAS^3/new_data_full_reduce/012/d,Macro,1,704,764,3897,60
012,/home/yww/CAS^3/new_data_full_reduce/012/e,Macro,1,317,337,2428,20
012,/home/yww/CAS^3/new_data_full_reduce/012/e,Macro,1,451,512,2428,61
012,/home/yww/CAS^3/new_data_full_reduce/012/g,Macro,1,672,697,2069,25
012,/home/yww/CAS^3/new_data_full_reduce/012/g,Macro,1,753,792,2069,39
012,/home/yww/CAS^3/new_data_full_reduce/012/g,Macro,1,1102,1153,2069,51
012,/home/yww/CAS^3/new_data_full_reduce/012/g,Macro,1,1826,1869,2069,43
012,/home/yww/CAS^3/new_data_full_reduce/012/h,Macro,1,1047,1082,2864,35
012,/home/yww/CAS^3/new_data_full_reduce/012/h,Macro,1,1157,1225,2864,68
012,/home/yww/CAS^3/new_data_full_reduce/012/i,Macro,1,95,115,3501,20
012,/home/yww/CAS^3/new_data_full_reduce/012/i,Macro,1,2729,2766,3501,37
012,/home/yww/CAS^3/new_data_full_reduce/012/j,Macro,1,185,212,1574,27
012,/home/yww/CAS^3/new_data_full_reduce/012/j,Macro,1,338,374,1574,36
012,/home/yww/CAS^3/new_data_full_reduce/012/j,Macro,1,378,415,1574,37
012,/home/yww/CAS^3/new_data_full_reduce/012/j,Macro,1,756,790,1574,34
012,/home/yww/CAS^3/new_data_full_reduce/012/j,Micro,2,25,40,1574,15
012,/home/yww/CAS^3/new_data_full_reduce/012/k,Macro,1,1169,1215,1988,46
012,/home/yww/CAS^3/new_data_full_reduce/012/k,Macro,1,1455,1563,1988,108
012,/home/yww/CAS^3/new_data_full_reduce/012/l,Macro,1,2483,2509,3400,26
012,/home/yww/CAS^3/new_data_full_reduce/012/l,Macro,1,2839,2885,3400,46
012,/home/yww/CAS^3/new_data_full_reduce/012/m,Macro,1,23,82,2301,59
012,/home/yww/CAS^3/new_data_full_reduce/012/m,Macro,1,415,442,2301,27
013,/home/yww/CAS^3/new_data_full_reduce/013/b,Macro,1,86,164,991,78
013,/home/yww/CAS^3/new_data_full_reduce/013/d,Macro,1,129,205,3726,76
013,/home/yww/CAS^3/new_data_full_reduce/013/d,Macro,1,513,623,3726,110
013,/home/yww/CAS^3/new_data_full_reduce/013/d,Macro,1,1142,1177,3726,35
013,/home/yww/CAS^3/new_data_full_reduce/013/d,Micro,2,783,796,3726,13
013,/home/yww/CAS^3/new_data_full_reduce/013/e,Macro,1,1,110,2657,109
013,/home/yww/CAS^3/new_data_full_reduce/013/e,Macro,1,241,280,2657,39
013,/home/yww/CAS^3/new_data_full_reduce/013/e,Macro,1,481,512,2657,31
013,/home/yww/CAS^3/new_data_full_reduce/013/e,Macro,1,790,858,2657,68
013,/home/yww/CAS^3/new_data_full_reduce/013/e,Macro,1,1812,1848,2657,36
013,/home/yww/CAS^3/new_data_full_reduce/013/f,Macro,1,125,163,1721,38
013,/home/yww/CAS^3/new_data_full_reduce/013/f,Macro,1,1431,1457,1721,26
013,/home/yww/CAS^3/new_data_full_reduce/013/g,Macro,1,1056,1132,2317,76
013,/home/yww/CAS^3/new_data_full_reduce/013/h,Macro,1,1478,1530,2714,52
013,/home/yww/CAS^3/new_data_full_reduce/013/h,Macro,1,2634,2702,2714,68
013,/home/yww/CAS^3/new_data_full_reduce/013/i,Macro,1,2949,2987,3481,38
013,/home/yww/CAS^3/new_data_full_reduce/013/j,Macro,1,113,183,1635,70
013,/home/yww/CAS^3/new_data_full_reduce/013/j,Macro,1,200,291,1635,91
013,/home/yww/CAS^3/new_data_full_reduce/013/j,Macro,1,518,535,1635,17
013,/home/yww/CAS^3/new_data_full_reduce/013/j,Macro,1,559,593,1635,34
013,/home/yww/CAS^3/new_data_full_reduce/013/j,Micro,2,593,606,1635,13
013,/home/yww/CAS^3/new_data_full_reduce/013/k,Macro,1,495,597,2233,102
013,/home/yww/CAS^3/new_data_full_reduce/013/k,Macro,1,2198,2232,2233,34
013,/home/yww/CAS^3/new_data_full_reduce/013/l,Macro,1,521,551,3372,30
013,/home/yww/CAS^3/new_data_full_reduce/013/l,Micro,2,2094,2105,3372,11
013,/home/yww/CAS^3/new_data_full_reduce/013/m,Macro,1,514,544,2353,30
013,/home/yww/CAS^3/new_data_full_reduce/013/m,Macro,1,1624,1656,2353,32
014,/home/yww/CAS^3/new_data_full_reduce/014/a,Macro,1,33,148,782,115
014,/home/yww/CAS^3/new_data_full_reduce/014/d,Macro,1,76,131,3495,55
014,/home/yww/CAS^3/new_data_full_reduce/014/e,Macro,1,384,410,2600,26
014,/home/yww/CAS^3/new_data_full_reduce/014/h,Macro,1,92,129,2252,37
014,/home/yww/CAS^3/new_data_full_reduce/014/h,Macro,1,362,423,2252,61
014,/home/yww/CAS^3/new_data_full_reduce/014/h,Macro,1,876,922,2252,46
014,/home/yww/CAS^3/new_data_full_reduce/014/h,Macro,1,1092,1145,2252,53
014,/home/yww/CAS^3/new_data_full_reduce/014/h,Macro,1,1642,1692,2252,50
014,/home/yww/CAS^3/new_data_full_reduce/014/h,Macro,1,1900,1946,2252,46
014,/home/yww/CAS^3/new_data_full_reduce/014/i,Macro,1,64,183,3443,119
014,/home/yww/CAS^3/new_data_full_reduce/014/i,Macro,1,1561,1640,3443,79
014,/home/yww/CAS^3/new_data_full_reduce/014/i,Macro,1,2140,2174,3443,34
014,/home/yww/CAS^3/new_data_full_reduce/014/j,Macro,1,113,137,1649,24
014,/home/yww/CAS^3/new_data_full_reduce/014/j,Macro,1,292,349,1649,57
014,/home/yww/CAS^3/new_data_full_reduce/014/l,Macro,1,356,385,3409,29
014,/home/yww/CAS^3/new_data_full_reduce/014/l,Macro,1,477,506,3409,29
014,/home/yww/CAS^3/new_data_full_reduce/014/l,Macro,1,2177,2219,3409,42
014,/home/yww/CAS^3/new_data_full_reduce/014/l,Macro,1,2660,2703,3409,43
015,/home/yww/CAS^3/new_data_full_reduce/015/j,Macro,1,563,663,1569,100
015,/home/yww/CAS^3/new_data_full_reduce/015/j,Macro,1,672,720,1569,48
015,/home/yww/CAS^3/new_data_full_reduce/015/j,Macro,1,1003,1064,1569,61
015,/home/yww/CAS^3/new_data_full_reduce/015/j,Micro,2,25,40,1569,15
015,/home/yww/CAS^3/new_data_full_reduce/015/j,Micro,2,1558,1567,1569,9
015,/home/yww/CAS^3/new_data_full_reduce/015/k,Macro,1,607,696,2246,89
015,/home/yww/CAS^3/new_data_full_reduce/015/k,Macro,1,986,1028,2246,42
015,/home/yww/CAS^3/new_data_full_reduce/015/k,Macro,1,1930,2004,2246,74
015,/home/yww/CAS^3/new_data_full_reduce/015/k,Macro,1,2116,2187,2246,71
015,/home/yww/CAS^3/new_data_full_reduce/015/l,Micro,2,1396,1404,3379,8
015,/home/yww/CAS^3/new_data_full_reduce/015/l,Micro,2,2975,2988,3379,13
016,/home/yww/CAS^3/new_data_full_reduce/016/g,Macro,1,157,232,2185,75
017,/home/yww/CAS^3/new_data_full_reduce/017/c,Macro,1,403,469,2754,66
017,/home/yww/CAS^3/new_data_full_reduce/017/d,Macro,1,3,50,3795,47
017,/home/yww/CAS^3/new_data_full_reduce/017/d,Macro,1,149,264,3795,115
017,/home/yww/CAS^3/new_data_full_reduce/017/f,Macro,1,121,199,1955,78
017,/home/yww/CAS^3/new_data_full_reduce/017/f,Macro,1,577,602,1955,25
017,/home/yww/CAS^3/new_data_full_reduce/017/h,Macro,1,168,250,2993,82
017,/home/yww/CAS^3/new_data_full_reduce/017/l,Macro,1,2354,2404,3416,50
017,/home/yww/CAS^3/new_data_full_reduce/017/m,Macro,1,1151,1222,2421,71
017,/home/yww/CAS^3/new_data_full_reduce/017/m,Micro,2,955,970,2421,15
017,/home/yww/CAS^3/new_data_full_reduce/017/m,Micro,2,1124,1136,2421,12
039,/home/yww/CAS^3/new_data_full_reduce/039/a,Macro,1,25,94,1021,69
039,/home/yww/CAS^3/new_data_full_reduce/039/a,Macro,1,265,291,1021,26
039,/home/yww/CAS^3/new_data_full_reduce/039/b,Macro,1,936,974,1267,38
039,/home/yww/CAS^3/new_data_full_reduce/039/g,Macro,1,44,95,2739,51
039,/home/yww/CAS^3/new_data_full_reduce/039/g,Macro,1,108,166,2739,58
039,/home/yww/CAS^3/new_data_full_reduce/039/g,Macro,1,181,255,2739,74
039,/home/yww/CAS^3/new_data_full_reduce/039/i,Macro,1,543,625,4333,82
039,/home/yww/CAS^3/new_data_full_reduce/039/i,Macro,1,4182,4279,4333,97
039,/home/yww/CAS^3/new_data_full_reduce/039/k,Macro,1,155,177,2772,22
039,/home/yww/CAS^3/new_data_full_reduce/039/k,Macro,1,2428,2548,2772,120
040,/home/yww/CAS^3/new_data_full_reduce/040/c,Macro,1,212,280,3470,68
040,/home/yww/CAS^3/new_data_full_reduce/040/c,Macro,1,736,773,3470,37
040,/home/yww/CAS^3/new_data_full_reduce/040/c,Macro,1,3271,3341,3470,70
040,/home/yww/CAS^3/new_data_full_reduce/040/e,Macro,1,122,184,3083,62
040,/home/yww/CAS^3/new_data_full_reduce/040/e,Macro,1,1414,1517,3083,103
040,/home/yww/CAS^3/new_data_full_reduce/040/e,Macro,1,1517,1542,3083,25
040,/home/yww/CAS^3/new_data_full_reduce/040/e,Macro,1,1606,1677,3083,71
040,/home/yww/CAS^3/new_data_full_reduce/040/e,Macro,1,1697,1725,3083,28
040,/home/yww/CAS^3/new_data_full_reduce/040/e,Macro,1,1743,1806,3083,63
040,/home/yww/CAS^3/new_data_full_reduce/040/e,Macro,1,1844,1908,3083,64
040,/home/yww/CAS^3/new_data_full_reduce/040/e,Macro,1,1914,1964,3083,50
040,/home/yww/CAS^3/new_data_full_reduce/040/e,Macro,1,1979,2013,3083,34
040,/home/yww/CAS^3/new_data_full_reduce/040/e,Macro,1,2075,2163,3083,88
040,/home/yww/CAS^3/new_data_full_reduce/040/e,Macro,1,2163,2185,3083,22
040,/home/yww/CAS^3/new_data_full_reduce/040/e,Macro,1,2185,2251,3083,66
040,/home/yww/CAS^3/new_data_full_reduce/040/e,Macro,1,2274,2300,3083,26
040,/home/yww/CAS^3/new_data_full_reduce/040/e,Macro,1,2452,2543,3083,91
040,/home/yww/CAS^3/new_data_full_reduce/040/e,Macro,1,2633,2680,3083,47
040,/home/yww/CAS^3/new_data_full_reduce/040/e,Macro,1,2686,2778,3083,92
040,/home/yww/CAS^3/new_data_full_reduce/040/e,Macro,1,2778,2818,3083,40
040,/home/yww/CAS^3/new_data_full_reduce/040/e,Macro,1,2824,2867,3083,43
040,/home/yww/CAS^3/new_data_full_reduce/040/e,Macro,1,3014,3059,3083,45
040,/home/yww/CAS^3/new_data_full_reduce/040/e,Micro,2,1964,1979,3083,15
040,/home/yww/CAS^3/new_data_full_reduce/040/f,Macro,1,1,46,2310,45
040,/home/yww/CAS^3/new_data_full_reduce/040/f,Macro,1,361,440,2310,79
040,/home/yww/CAS^3/new_data_full_reduce/040/f,Macro,1,1057,1090,2310,33
040,/home/yww/CAS^3/new_data_full_reduce/040/f,Macro,1,1253,1325,2310,72
040,/home/yww/CAS^3/new_data_full_reduce/040/f,Macro,1,1336,1359,2310,23
040,/home/yww/CAS^3/new_data_full_reduce/040/f,Macro,1,1368,1410,2310,42
040,/home/yww/CAS^3/new_data_full_reduce/040/f,Macro,1,1423,1447,2310,24
040,/home/yww/CAS^3/new_data_full_reduce/040/g,Macro,1,649,719,2740,70
040,/home/yww/CAS^3/new_data_full_reduce/040/g,Macro,1,1012,1046,2740,34
040,/home/yww/CAS^3/new_data_full_reduce/040/g,Macro,1,1587,1665,2740,78
040,/home/yww/CAS^3/new_data_full_reduce/040/g,Macro,1,1776,1880,2740,104
040,/home/yww/CAS^3/new_data_full_reduce/040/g,Macro,1,1880,1947,2740,67
040,/home/yww/CAS^3/new_data_full_reduce/040/g,Macro,1,2254,2338,2740,84
040,/home/yww/CAS^3/new_data_full_reduce/040/g,Macro,1,2524,2612,2740,88
040,/home/yww/CAS^3/new_data_full_reduce/040/h,Macro,1,642,698,3508,56
040,/home/yww/CAS^3/new_data_full_reduce/040/i,Macro,1,1086,1147,4335,61
040,/home/yww/CAS^3/new_data_full_reduce/040/i,Macro,1,1206,1298,4335,92
040,/home/yww/CAS^3/new_data_full_reduce/040/i,Macro,1,2656,2737,4335,81
040,/home/yww/CAS^3/new_data_full_reduce/040/i,Macro,1,2942,2985,4335,43
040,/home/yww/CAS^3/new_data_full_reduce/040/i,Macro,1,4133,4241,4335,108
040,/home/yww/CAS^3/new_data_full_reduce/040/j,Macro,1,132,180,1999,48
040,/home/yww/CAS^3/new_data_full_reduce/040/j,Macro,1,295,324,1999,29
040,/home/yww/CAS^3/new_data_full_reduce/040/j,Macro,1,720,817,1999,97
040,/home/yww/CAS^3/new_data_full_reduce/040/j,Macro,1,919,964,1999,45
040,/home/yww/CAS^3/new_data_full_reduce/040/k,Macro,1,161,247,2773,86
040,/home/yww/CAS^3/new_data_full_reduce/040/k,Macro,1,449,532,2773,83
040,/home/yww/CAS^3/new_data_full_reduce/040/k,Macro,1,828,904,2773,76
040,/home/yww/CAS^3/new_data_full_reduce/040/k,Macro,1,921,961,2773,40
040,/home/yww/CAS^3/new_data_full_reduce/040/k,Macro,1,989,1011,2773,22
040,/home/yww/CAS^3/new_data_full_reduce/040/k,Macro,1,1024,1072,2773,48
041,/home/yww/CAS^3/new_data_full_reduce/041/a,Macro,1,89,129,1020,40
041,/home/yww/CAS^3/new_data_full_reduce/041/a,Macro,1,270,301,1020,31
041,/home/yww/CAS^3/new_data_full_reduce/041/a,Macro,1,372,424,1020,52
041,/home/yww/CAS^3/new_data_full_reduce/041/a,Macro,1,459,528,1020,69
041,/home/yww/CAS^3/new_data_full_reduce/041/a,Macro,1,527,577,1020,50
041,/home/yww/CAS^3/new_data_full_reduce/041/a,Macro,1,929,1018,1020,89
041,/home/yww/CAS^3/new_data_full_reduce/041/b,Macro,1,176,213,1265,37
041,/home/yww/CAS^3/new_data_full_reduce/041/b,Macro,1,222,242,1265,20
041,/home/yww/CAS^3/new_data_full_reduce/041/c,Macro,1,492,577,3468,85
041,/home/yww/CAS^3/new_data_full_reduce/041/d,Macro,1,4678,4771,4818,93
041,/home/yww/CAS^3/new_data_full_reduce/041/e,Macro,1,936,972,3081,36
041,/home/yww/CAS^3/new_data_full_reduce/041/k,Macro,1,436,461,2772,25
042,/home/yww/CAS^3/new_data_full_reduce/042/a,Macro,1,28,76,1019,48
042,/home/yww/CAS^3/new_data_full_reduce/042/a,Macro,1,328,366,1019,38
042,/home/yww/CAS^3/new_data_full_reduce/042/a,Macro,1,525,558,1019,33
042,/home/yww/CAS^3/new_data_full_reduce/042/a,Macro,1,716,746,1019,30
042,/home/yww/CAS^3/new_data_full_reduce/042/b,Macro,1,231,257,1268,26
042,/home/yww/CAS^3/new_data_full_reduce/042/b,Macro,1,329,411,1268,82
042,/home/yww/CAS^3/new_data_full_reduce/042/b,Macro,1,575,612,1268,37
042,/home/yww/CAS^3/new_data_full_reduce/042/b,Macro,1,1125,1205,1268,80
042,/home/yww/CAS^3/new_data_full_reduce/042/b,Macro,1,1229,1258,1268,29
042,/home/yww/CAS^3/new_data_full_reduce/042/c,Macro,1,313,350,3471,37
042,/home/yww/CAS^3/new_data_full_reduce/042/c,Macro,1,478,537,3471,59
042,/home/yww/CAS^3/new_data_full_reduce/042/c,Macro,1,2737,2809,3471,72
042,/home/yww/CAS^3/new_data_full_reduce/042/d,Macro,1,1118,1169,4817,51
042,/home/yww/CAS^3/new_data_full_reduce/042/d,Macro,1,1393,1455,4817,62
042,/home/yww/CAS^3/new_data_full_reduce/042/d,Macro,1,2587,2656,4817,69
042,/home/yww/CAS^3/new_data_full_reduce/042/d,Macro,1,3248,3297,4817,49
042,/home/yww/CAS^3/new_data_full_reduce/042/d,Macro,1,3487,3527,4817,40
042,/home/yww/CAS^3/new_data_full_reduce/042/d,Macro,1,3967,4005,4817,38
042,/home/yww/CAS^3/new_data_full_reduce/042/e,Macro,1,73,151,3083,78
042,/home/yww/CAS^3/new_data_full_reduce/042/e,Macro,1,432,499,3083,67
042,/home/yww/CAS^3/new_data_full_reduce/042/e,Macro,1,524,603,3083,79
042,/home/yww/CAS^3/new_data_full_reduce/042/e,Macro,1,2023,2079,3083,56
042,/home/yww/CAS^3/new_data_full_reduce/042/e,Macro,1,2378,2412,3083,34
042,/home/yww/CAS^3/new_data_full_reduce/042/e,Macro,1,2720,2756,3083,36
042,/home/yww/CAS^3/new_data_full_reduce/042/f,Macro,1,1853,1880,2292,27
042,/home/yww/CAS^3/new_data_full_reduce/042/h,Macro,1,1286,1342,2922,56
042,/home/yww/CAS^3/new_data_full_reduce/042/j,Macro,1,238,284,2000,46
042,/home/yww/CAS^3/new_data_full_reduce/042/j,Macro,1,682,769,2000,87
042,/home/yww/CAS^3/new_data_full_reduce/042/j,Macro,1,944,1006,2000,62
042,/home/yww/CAS^3/new_data_full_reduce/042/j,Macro,1,1165,1196,2000,31
042,/home/yww/CAS^3/new_data_full_reduce/042/j,Macro,1,1196,1244,2000,48
042,/home/yww/CAS^3/new_data_full_reduce/042/j,Macro,1,1244,1316,2000,72
042,/home/yww/CAS^3/new_data_full_reduce/042/j,Macro,1,1401,1461,2000,60
042,/home/yww/CAS^3/new_data_full_reduce/042/j,Macro,1,1522,1579,2000,57
042,/home/yww/CAS^3/new_data_full_reduce/042/j,Macro,1,1579,1666,2000,87
042,/home/yww/CAS^3/new_data_full_reduce/042/k,Macro,1,1053,1103,2773,50
042,/home/yww/CAS^3/new_data_full_reduce/042/k,Macro,1,1385,1445,2773,60
042,/home/yww/CAS^3/new_data_full_reduce/042/k,Macro,1,2429,2476,2773,47
042,/home/yww/CAS^3/new_data_full_reduce/042/l,Macro,1,1152,1193,3569,41
042,/home/yww/CAS^3/new_data_full_reduce/042/l,Macro,1,1633,1673,3569,40
042,/home/yww/CAS^3/new_data_full_reduce/042/m,Macro,1,704,750,2890,46
042,/home/yww/CAS^3/new_data_full_reduce/042/m,Macro,1,1252,1283,2890,31
042,/home/yww/CAS^3/new_data_full_reduce/042/m,Macro,1,1801,1857,2890,56
042,/home/yww/CAS^3/new_data_full_reduce/042/m,Macro,1,2320,2380,2890,60
042,/home/yww/CAS^3/new_data_full_reduce/042/m,Macro,1,2772,2797,2890,25
077,/home/yww/CAS^3/new_data_full_reduce/077/a,Macro,1,114,219,1020,105
077,/home/yww/CAS^3/new_data_full_reduce/077/a,Macro,1,228,248,1020,20
077,/home/yww/CAS^3/new_data_full_reduce/077/a,Macro,1,303,337,1020,34
077,/home/yww/CAS^3/new_data_full_reduce/077/a,Macro,1,390,428,1020,38
077,/home/yww/CAS^3/new_data_full_reduce/077/a,Macro,1,795,820,1020,25
077,/home/yww/CAS^3/new_data_full_reduce/077/b,Macro,1,1,58,1265,57
077,/home/yww/CAS^3/new_data_full_reduce/077/b,Macro,1,66,139,1265,73
077,/home/yww/CAS^3/new_data_full_reduce/077/b,Macro,1,520,611,1265,91
077,/home/yww/CAS^3/new_data_full_reduce/077/d,Macro,1,19,69,4819,50
077,/home/yww/CAS^3/new_data_full_reduce/077/d,Micro,2,4702,4717,4819,15
077,/home/yww/CAS^3/new_data_full_reduce/077/e,Macro,1,40,84,3082,44
077,/home/yww/CAS^3/new_data_full_reduce/077/e,Macro,1,601,637,3082,36
077,/home/yww/CAS^3/new_data_full_reduce/077/f,Macro,1,371,473,1996,102
077,/home/yww/CAS^3/new_data_full_reduce/077/f,Macro,1,484,536,1996,52
077,/home/yww/CAS^3/new_data_full_reduce/077/f,Macro,1,1251,1286,1996,35
077,/home/yww/CAS^3/new_data_full_reduce/077/f,Macro,1,1360,1424,1996,64
077,/home/yww/CAS^3/new_data_full_reduce/077/f,Macro,1,1539,1584,1996,45
077,/home/yww/CAS^3/new_data_full_reduce/077/f,Macro,1,1953,1989,1996,36
077,/home/yww/CAS^3/new_data_full_reduce/077/f,Micro,2,603,615,1996,12
077,/home/yww/CAS^3/new_data_full_reduce/077/g,Macro,1,283,325,2741,42
077,/home/yww/CAS^3/new_data_full_reduce/077/g,Macro,1,2361,2395,2741,34
077,/home/yww/CAS^3/new_data_full_reduce/077/h,Macro,1,75,182,3505,107
077,/home/yww/CAS^3/new_data_full_reduce/077/h,Macro,1,786,842,3505,56
077,/home/yww/CAS^3/new_data_full_reduce/077/h,Macro,1,1582,1669,3505,87
077,/home/yww/CAS^3/new_data_full_reduce/077/h,Macro,1,2526,2585,3505,59
077,/home/yww/CAS^3/new_data_full_reduce/077/h,Macro,1,3052,3126,3505,74
077,/home/yww/CAS^3/new_data_full_reduce/077/i,Macro,1,337,426,4334,89
077,/home/yww/CAS^3/new_data_full_reduce/077/i,Macro,1,3734,3845,4334,111
077,/home/yww/CAS^3/new_data_full_reduce/077/l,Macro,1,3870,3891,4189,21
077,/home/yww/CAS^3/new_data_full_reduce/077/m,Macro,1,10,113,2890,103
077,/home/yww/CAS^3/new_data_full_reduce/077/m,Macro,1,113,164,2890,51
077,/home/yww/CAS^3/new_data_full_reduce/077/m,Macro,1,183,200,2890,17
077,/home/yww/CAS^3/new_data_full_reduce/077/m,Macro,1,489,516,2890,27
077,/home/yww/CAS^3/new_data_full_reduce/077/m,Macro,1,1462,1536,2890,74
138,/home/yww/CAS^3/new_data_full_reduce/138/c,Macro,1,16,55,3471,39
138,/home/yww/CAS^3/new_data_full_reduce/138/c,Macro,1,284,300,3471,16
138,/home/yww/CAS^3/new_data_full_reduce/138/k,Macro,1,58,176,2772,118
139,/home/yww/CAS^3/new_data_full_reduce/139/b,Macro,1,9,120,1268,111
139,/home/yww/CAS^3/new_data_full_reduce/139/b,Macro,1,503,526,1268,23
139,/home/yww/CAS^3/new_data_full_reduce/139/f,Macro,1,37,117,2310,80
139,/home/yww/CAS^3/new_data_full_reduce/139/l,Macro,1,500,540,4191,40
139,/home/yww/CAS^3/new_data_full_reduce/139/l,Micro,2,456,470,4191,14
140,/home/yww/CAS^3/new_data_full_reduce/140/d,Macro,1,666,713,4819,47
140,/home/yww/CAS^3/new_data_full_reduce/140/d,Macro,1,995,1095,4819,100
140,/home/yww/CAS^3/new_data_full_reduce/140/f,Macro,1,284,372,2311,88
140,/home/yww/CAS^3/new_data_full_reduce/140/f,Macro,1,1521,1569,2311,48
140,/home/yww/CAS^3/new_data_full_reduce/140/f,Macro,1,1894,1932,2311,38
142,/home/yww/CAS^3/new_data_full_reduce/142/a,Macro,1,6,27,1020,21
142,/home/yww/CAS^3/new_data_full_reduce/142/a,Macro,1,63,112,1020,49
142,/home/yww/CAS^3/new_data_full_reduce/142/a,Macro,1,817,885,1020,68
142,/home/yww/CAS^3/new_data_full_reduce/142/a,Micro,2,631,644,1020,13
142,/home/yww/CAS^3/new_data_full_reduce/142/b,Macro,1,32,54,1267,22
142,/home/yww/CAS^3/new_data_full_reduce/142/c,Macro,1,788,848,3471,60
142,/home/yww/CAS^3/new_data_full_reduce/142/c,Macro,1,1708,1744,3471,36
142,/home/yww/CAS^3/new_data_full_reduce/142/c,Macro,1,2302,2339,3471,37
142,/home/yww/CAS^3/new_data_full_reduce/142/c,Macro,1,3008,3042,3471,34
142,/home/yww/CAS^3/new_data_full_reduce/142/d,Macro,1,547,572,4817,25
142,/home/yww/CAS^3/new_data_full_reduce/142/d,Macro,1,623,677,4817,54
142,/home/yww/CAS^3/new_data_full_reduce/142/d,Macro,1,837,859,4817,22
142,/home/yww/CAS^3/new_data_full_reduce/142/d,Macro,1,1005,1050,4817,45
142,/home/yww/CAS^3/new_data_full_reduce/142/d,Macro,1,1300,1331,4817,31
142,/home/yww/CAS^3/new_data_full_reduce/142/d,Macro,1,1890,1936,4817,46
142,/home/yww/CAS^3/new_data_full_reduce/142/d,Macro,1,2750,2778,4817,28
142,/home/yww/CAS^3/new_data_full_reduce/142/d,Macro,1,2858,2888,4817,30
142,/home/yww/CAS^3/new_data_full_reduce/142/e,Macro,1,215,251,3083,36
142,/home/yww/CAS^3/new_data_full_reduce/142/e,Macro,1,846,905,3083,59
142,/home/yww/CAS^3/new_data_full_reduce/142/e,Macro,1,1102,1144,3083,42
142,/home/yww/CAS^3/new_data_full_reduce/142/e,Macro,1,1509,1555,3083,46
142,/home/yww/CAS^3/new_data_full_reduce/142/e,Macro,1,1722,1793,3083,71
142,/home/yww/CAS^3/new_data_full_reduce/142/e,Macro,1,2334,2358,3083,24
142,/home/yww/CAS^3/new_data_full_reduce/142/e,Macro,1,2385,2414,3083,29
142,/home/yww/CAS^3/new_data_full_reduce/142/e,Macro,1,2553,2584,3083,31
142,/home/yww/CAS^3/new_data_full_reduce/142/f,Macro,1,1,118,2309,117
142,/home/yww/CAS^3/new_data_full_reduce/142/f,Macro,1,399,475,2309,76
142,/home/yww/CAS^3/new_data_full_reduce/142/f,Macro,1,813,874,2309,61
142,/home/yww/CAS^3/new_data_full_reduce/142/f,Macro,1,1003,1111,2309,108
142,/home/yww/CAS^3/new_data_full_reduce/142/f,Macro,1,1566,1607,2309,41
142,/home/yww/CAS^3/new_data_full_reduce/142/f,Macro,1,1962,1990,2309,28
142,/home/yww/CAS^3/new_data_full_reduce/142/f,Macro,1,2009,2036,2309,27
142,/home/yww/CAS^3/new_data_full_reduce/142/g,Macro,1,1,83,2741,82
142,/home/yww/CAS^3/new_data_full_reduce/142/g,Macro,1,102,176,2741,74
142,/home/yww/CAS^3/new_data_full_reduce/142/g,Macro,1,324,379,2741,55
142,/home/yww/CAS^3/new_data_full_reduce/142/g,Macro,1,738,780,2741,42
142,/home/yww/CAS^3/new_data_full_reduce/142/g,Macro,1,946,1031,2741,85
142,/home/yww/CAS^3/new_data_full_reduce/142/g,Macro,1,2100,2172,2741,72
142,/home/yww/CAS^3/new_data_full_reduce/142/g,Macro,1,2358,2396,2741,38
142,/home/yww/CAS^3/new_data_full_reduce/142/g,Micro,2,1560,1572,2741,12
142,/home/yww/CAS^3/new_data_full_reduce/142/h,Macro,1,195,246,3507,51
142,/home/yww/CAS^3/new_data_full_reduce/142/h,Macro,1,346,429,3507,83
142,/home/yww/CAS^3/new_data_full_reduce/142/h,Macro,1,748,772,3507,24
142,/home/yww/CAS^3/new_data_full_reduce/142/h,Macro,1,819,848,3507,29
142,/home/yww/CAS^3/new_data_full_reduce/142/h,Macro,1,1647,1668,3507,21
142,/home/yww/CAS^3/new_data_full_reduce/142/h,Macro,1,1844,1885,3507,41
142,/home/yww/CAS^3/new_data_full_reduce/142/h,Macro,1,2999,3063,3507,64
142,/home/yww/CAS^3/new_data_full_reduce/142/h,Micro,2,1419,1429,3507,10
142,/home/yww/CAS^3/new_data_full_reduce/142/h,Micro,2,2984,2999,3507,15
142,/home/yww/CAS^3/new_data_full_reduce/142/i,Macro,1,119,185,4335,66
142,/home/yww/CAS^3/new_data_full_reduce/142/i,Macro,1,334,370,4335,36
142,/home/yww/CAS^3/new_data_full_reduce/142/i,Macro,1,648,691,4335,43
142,/home/yww/CAS^3/new_data_full_reduce/142/i,Macro,1,919,962,4335,43
142,/home/yww/CAS^3/new_data_full_reduce/142/i,Macro,1,1356,1411,4335,55
142,/home/yww/CAS^3/new_data_full_reduce/142/i,Macro,1,2993,3057,4335,64
142,/home/yww/CAS^3/new_data_full_reduce/142/i,Macro,1,3341,3389,4335,48
142,/home/yww/CAS^3/new_data_full_reduce/142/i,Macro,1,3664,3688,4335,24
142,/home/yww/CAS^3/new_data_full_reduce/142/i,Micro,2,511,525,4335,14
142,/home/yww/CAS^3/new_data_full_reduce/142/i,Micro,2,3276,3285,4335,9
142,/home/yww/CAS^3/new_data_full_reduce/142/j,Macro,1,42,96,1999,54
142,/home/yww/CAS^3/new_data_full_reduce/142/j,Macro,1,267,310,1999,43
142,/home/yww/CAS^3/new_data_full_reduce/142/j,Macro,1,554,620,1999,66
142,/home/yww/CAS^3/new_data_full_reduce/142/j,Macro,1,703,748,1999,45
142,/home/yww/CAS^3/new_data_full_reduce/142/j,Macro,1,1726,1782,1999,56
142,/home/yww/CAS^3/new_data_full_reduce/142/j,Macro,1,1935,1954,1999,19
142,/home/yww/CAS^3/new_data_full_reduce/142/k,Macro,1,17,49,2773,32
142,/home/yww/CAS^3/new_data_full_reduce/142/k,Macro,1,166,245,2773,79
142,/home/yww/CAS^3/new_data_full_reduce/142/k,Macro,1,457,533,2773,76
142,/home/yww/CAS^3/new_data_full_reduce/142/l,Macro,1,79,111,4191,32
142,/home/yww/CAS^3/new_data_full_reduce/142/l,Macro,1,573,612,4191,39
142,/home/yww/CAS^3/new_data_full_reduce/142/l,Macro,1,674,762,4191,88
142,/home/yww/CAS^3/new_data_full_reduce/142/l,Macro,1,1010,1074,4191,64
142,/home/yww/CAS^3/new_data_full_reduce/142/l,Macro,1,1979,2018,4191,39
142,/home/yww/CAS^3/new_data_full_reduce/142/l,Macro,1,2098,2135,4191,37
142,/home/yww/CAS^3/new_data_full_reduce/142/m,Macro,1,64,172,2887,108
142,/home/yww/CAS^3/new_data_full_reduce/142/m,Macro,1,1108,1174,2887,66
142,/home/yww/CAS^3/new_data_full_reduce/142/m,Macro,1,1543,1580,2887,37
142,/home/yww/CAS^3/new_data_full_reduce/142/m,Macro,1,2702,2751,2887,49
143,/home/yww/CAS^3/new_data_full_reduce/143/c,Macro,1,156,175,3470,19
143,/home/yww/CAS^3/new_data_full_reduce/143/c,Macro,1,2557,2587,3470,30
143,/home/yww/CAS^3/new_data_full_reduce/143/e,Macro,1,1,45,3083,44
143,/home/yww/CAS^3/new_data_full_reduce/143/g,Macro,1,12,48,2740,36
143,/home/yww/CAS^3/new_data_full_reduce/143/g,Macro,1,383,423,2740,40
143,/home/yww/CAS^3/new_data_full_reduce/143/g,Macro,1,989,1070,2740,81
143,/home/yww/CAS^3/new_data_full_reduce/143/h,Macro,1,134,204,3506,70
143,/home/yww/CAS^3/new_data_full_reduce/143/h,Macro,1,228,271,3506,43
143,/home/yww/CAS^3/new_data_full_reduce/143/h,Macro,1,3027,3096,3506,69
143,/home/yww/CAS^3/new_data_full_reduce/143/i,Macro,1,643,726,4336,83
143,/home/yww/CAS^3/new_data_full_reduce/143/i,Micro,2,2888,2903,4336,15
143,/home/yww/CAS^3/new_data_full_reduce/143/m,Macro,1,23,51,2889,28
143,/home/yww/CAS^3/new_data_full_reduce/143/m,Macro,1,97,135,2889,38
143,/home/yww/CAS^3/new_data_full_reduce/143/m,Macro,1,2051,2098,2889,47
143,/home/yww/CAS^3/new_data_full_reduce/143/m,Macro,1,2432,2501,2889,69
144,/home/yww/CAS^3/new_data_full_reduce/144/a,Micro,2,14,27,1019,13
144,/home/yww/CAS^3/new_data_full_reduce/144/c,Macro,1,223,294,3470,71
144,/home/yww/CAS^3/new_data_full_reduce/144/c,Macro,1,345,380,3470,35
144,/home/yww/CAS^3/new_data_full_reduce/144/d,Macro,1,1187,1216,4817,29
144,/home/yww/CAS^3/new_data_full_reduce/144/d,Macro,1,1857,1934,4817,77
144,/home/yww/CAS^3/new_data_full_reduce/144/d,Macro,1,3417,3515,4817,98
144,/home/yww/CAS^3/new_data_full_reduce/144/d,Macro,1,3892,3951,4817,59
144,/home/yww/CAS^3/new_data_full_reduce/144/d,Macro,1,4017,4074,4817,57
144,/home/yww/CAS^3/new_data_full_reduce/144/d,Micro,2,3039,3054,4817,15
144,/home/yww/CAS^3/new_data_full_reduce/144/d,Micro,2,4405,4416,4817,11
144,/home/yww/CAS^3/new_data_full_reduce/144/e,Macro,1,14,41,3083,27
144,/home/yww/CAS^3/new_data_full_reduce/144/e,Macro,1,766,793,3083,27
144,/home/yww/CAS^3/new_data_full_reduce/144/e,Macro,1,888,919,3083,31
144,/home/yww/CAS^3/new_data_full_reduce/144/e,Macro,1,1137,1233,3083,96
144,/home/yww/CAS^3/new_data_full_reduce/144/f,Macro,1,608,677,2311,69
144,/home/yww/CAS^3/new_data_full_reduce/144/f,Macro,1,759,855,2311,96
144,/home/yww/CAS^3/new_data_full_reduce/144/f,Macro,1,1590,1624,2311,34
144,/home/yww/CAS^3/new_data_full_reduce/144/f,Macro,1,1781,1836,2311,55
144,/home/yww/CAS^3/new_data_full_reduce/144/g,Macro,1,32,101,2741,69
144,/home/yww/CAS^3/new_data_full_reduce/144/g,Macro,1,498,580,2741,82
144,/home/yww/CAS^3/new_data_full_reduce/144/g,Macro,1,1007,1100,2741,93
144,/home/yww/CAS^3/new_data_full_reduce/144/g,Macro,1,1893,1947,2741,54
144,/home/yww/CAS^3/new_data_full_reduce/144/g,Macro,1,1971,2049,2741,78
144,/home/yww/CAS^3/new_data_full_reduce/144/g,Macro,1,2430,2499,2741,69
144,/home/yww/CAS^3/new_data_full_reduce/144/g,Macro,1,2555,2605,2741,50
144,/home/yww/CAS^3/new_data_full_reduce/144/g,Macro,1,2658,2718,2741,60
144,/home/yww/CAS^3/new_data_full_reduce/144/g,Micro,2,416,427,2741,11
144,/home/yww/CAS^3/new_data_full_reduce/144/g,Micro,2,878,892,2741,14
144,/home/yww/CAS^3/new_data_full_reduce/144/h,Macro,1,1,54,3507,53
144,/home/yww/CAS^3/new_data_full_reduce/144/h,Macro,1,360,404,3507,44
144,/home/yww/CAS^3/new_data_full_reduce/144/h,Macro,1,750,785,3507,35
144,/home/yww/CAS^3/new_data_full_reduce/144/h,Macro,1,1436,1496,3507,60
144,/home/yww/CAS^3/new_data_full_reduce/144/h,Macro,1,1886,1917,3507,31
144,/home/yww/CAS^3/new_data_full_reduce/144/h,Macro,1,1963,2013,3507,50
144,/home/yww/CAS^3/new_data_full_reduce/144/h,Macro,1,2043,2086,3507,43
144,/home/yww/CAS^3/new_data_full_reduce/144/h,Macro,1,2714,2782,3507,68
144,/home/yww/CAS^3/new_data_full_reduce/144/i,Macro,1,258,297,4336,39
144,/home/yww/CAS^3/new_data_full_reduce/144/i,Macro,1,2909,2959,4336,50
144,/home/yww/CAS^3/new_data_full_reduce/144/i,Macro,1,3129,3248,4336,119
144,/home/yww/CAS^3/new_data_full_reduce/144/i,Macro,1,3267,3306,4336,39
144,/home/yww/CAS^3/new_data_full_reduce/144/i,Macro,1,3662,3707,4336,45
144,/home/yww/CAS^3/new_data_full_reduce/144/i,Macro,1,3989,4041,4336,52
144,/home/yww/CAS^3/new_data_full_reduce/144/k,Macro,1,1,55,2771,54
144,/home/yww/CAS^3/new_data_full_reduce/144/k,Macro,1,68,130,2771,62
144,/home/yww/CAS^3/new_data_full_reduce/144/l,Macro,1,1139,1203,4190,64
144,/home/yww/CAS^3/new_data_full_reduce/144/l,Macro,1,2047,2147,4190,100
144,/home/yww/CAS^3/new_data_full_reduce/144/l,Macro,1,2437,2477,4190,40
144,/home/yww/CAS^3/new_data_full_reduce/144/l,Macro,1,2717,2822,4190,105
144,/home/yww/CAS^3/new_data_full_reduce/144/l,Macro,1,3141,3183,4190,42
144,/home/yww/CAS^3/new_data_full_reduce/144/l,Macro,1,3207,3254,4190,47
144,/home/yww/CAS^3/new_data_full_reduce/144/l,Macro,1,3295,3321,4190,26
144,/home/yww/CAS^3/new_data_full_reduce/144/l,Macro,1,3490,3559,4190,69
144,/home/yww/CAS^3/new_data_full_reduce/144/l,Micro,2,1098,1111,4190,13
144,/home/yww/CAS^3/new_data_full_reduce/144/m,Macro,1,216,259,2890,43
144,/home/yww/CAS^3/new_data_full_reduce/144/m,Macro,1,838,907,2890,69
144,/home/yww/CAS^3/new_data_full_reduce/144/m,Macro,1,1313,1397,2890,84
144,/home/yww/CAS^3/new_data_full_reduce/144/m,Macro,1,1549,1606,2890,57
144,/home/yww/CAS^3/new_data_full_reduce/144/m,Macro,1,1623,1741,2890,118
144,/home/yww/CAS^3/new_data_full_reduce/144/m,Macro,1,1876,1987,2890,111
144,/home/yww/CAS^3/new_data_full_reduce/144/m,Macro,1,2066,2085,2890,19
144,/home/yww/CAS^3/new_data_full_reduce/144/m,Micro,2,924,939,2890,15
145,/home/yww/CAS^3/new_data_full_reduce/145/a,Macro,1,7,51,1019,44
145,/home/yww/CAS^3/new_data_full_reduce/145/c,Macro,1,43,74,1110,31
145,/home/yww/CAS^3/new_data_full_reduce/145/c,Macro,1,535,596,1110,61
145,/home/yww/CAS^3/new_data_full_reduce/145/d,Macro,1,360,444,4818,84
145,/home/yww/CAS^3/new_data_full_reduce/145/d,Macro,1,1334,1374,4818,40
145,/home/yww/CAS^3/new_data_full_reduce/145/d,Macro,1,1404,1443,4818,39
145,/home/yww/CAS^3/new_data_full_reduce/145/d,Macro,1,4508,4531,4818,23
145,/home/yww/CAS^3/new_data_full_reduce/145/d,Macro,1,4668,4746,4818,78
145,/home/yww/CAS^3/new_data_full_reduce/145/e,Macro,1,15,67,3080,52
145,/home/yww/CAS^3/new_data_full_reduce/145/g,Macro,1,120,159,2732,39
145,/home/yww/CAS^3/new_data_full_reduce/145/g,Micro,2,145,153,2732,8
145,/home/yww/CAS^3/new_data_full_reduce/145/h,Macro,1,234,266,3505,32
145,/home/yww/CAS^3/new_data_full_reduce/145/h,Macro,1,565,586,3505,21
145,/home/yww/CAS^3/new_data_full_reduce/145/i,Macro,1,588,616,4333,28
145,/home/yww/CAS^3/new_data_full_reduce/145/j,Macro,1,162,241,1996,79
145,/home/yww/CAS^3/new_data_full_reduce/145/j,Macro,1,561,642,1996,81
145,/home/yww/CAS^3/new_data_full_reduce/145/k,Macro,1,278,325,2772,47
145,/home/yww/CAS^3/new_data_full_reduce/145/k,Macro,1,388,431,2772,43
145,/home/yww/CAS^3/new_data_full_reduce/145/l,Macro,1,380,417,4190,37
145,/home/yww/CAS^3/new_data_full_reduce/145/l,Macro,1,531,625,4190,94
145,/home/yww/CAS^3/new_data_full_reduce/145/l,Macro,1,1019,1052,4190,33
145,/home/yww/CAS^3/new_data_full_reduce/145/l,Macro,1,3444,3499,4190,55
145,/home/yww/CAS^3/new_data_full_reduce/145/m,Macro,1,726,765,2828,39
146,/home/yww/CAS^3/new_data_full_reduce/146/a,Macro,1,555,581,1019,26
146,/home/yww/CAS^3/new_data_full_reduce/146/a,Macro,1,837,943,1019,106
146,/home/yww/CAS^3/new_data_full_reduce/146/b,Macro,1,639,754,1266,115
146,/home/yww/CAS^3/new_data_full_reduce/146/d,Macro,1,13,40,4819,27
146,/home/yww/CAS^3/new_data_full_reduce/146/d,Macro,1,4668,4695,4819,27
146,/home/yww/CAS^3/new_data_full_reduce/146/e,Macro,1,335,429,3081,94
146,/home/yww/CAS^3/new_data_full_reduce/146/e,Macro,1,837,950,3081,113
146,/home/yww/CAS^3/new_data_full_reduce/146/f,Macro,1,1479,1587,2308,108
146,/home/yww/CAS^3/new_data_full_reduce/146/g,Macro,1,2228,2287,2733,59
146,/home/yww/CAS^3/new_data_full_reduce/146/g,Macro,1,2334,2356,2733,22
146,/home/yww/CAS^3/new_data_full_reduce/146/g,Macro,1,2430,2536,2733,106
146,/home/yww/CAS^3/new_data_full_reduce/146/i,Macro,1,313,345,4338,32
146,/home/yww/CAS^3/new_data_full_reduce/146/i,Macro,1,419,456,4338,37
146,/home/yww/CAS^3/new_data_full_reduce/146/k,Macro,1,1142,1173,2771,31
146,/home/yww/CAS^3/new_data_full_reduce/146/k,Macro,1,1403,1473,2771,70
146,/home/yww/CAS^3/new_data_full_reduce/146/m,Macro,1,514,618,2889,104
146,/home/yww/CAS^3/new_data_full_reduce/146/m,Macro,1,635,703,2889,68
146,/home/yww/CAS^3/new_data_full_reduce/146/m,Macro,1,803,838,2889,35
146,/home/yww/CAS^3/new_data_full_reduce/146/m,Macro,1,935,985,2889,50
147,/home/yww/CAS^3/new_data_full_reduce/147/a,Macro,1,26,133,1021,107
147,/home/yww/CAS^3/new_data_full_reduce/147/a,Macro,1,133,200,1021,67
147,/home/yww/CAS^3/new_data_full_reduce/147/a,Macro,1,216,331,1021,115
147,/home/yww/CAS^3/new_data_full_reduce/147/a,Macro,1,590,666,1021,76
147,/home/yww/CAS^3/new_data_full_reduce/147/b,Macro,1,5,73,1265,68
147,/home/yww/CAS^3/new_data_full_reduce/147/b,Macro,1,215,327,1265,112
147,/home/yww/CAS^3/new_data_full_reduce/147/b,Macro,1,753,791,1265,38
147,/home/yww/CAS^3/new_data_full_reduce/147/c,Macro,1,9,68,3472,59
147,/home/yww/CAS^3/new_data_full_reduce/147/c,Macro,1,184,250,3472,66
147,/home/yww/CAS^3/new_data_full_reduce/147/c,Macro,1,670,745,3472,75
147,/home/yww/CAS^3/new_data_full_reduce/147/c,Macro,1,845,873,3472,28
147,/home/yww/CAS^3/new_data_full_reduce/147/c,Macro,1,873,956,3472,83
147,/home/yww/CAS^3/new_data_full_reduce/147/c,Macro,1,3220,3266,3472,46
147,/home/yww/CAS^3/new_data_full_reduce/147/d,Macro,1,1156,1204,4818,48
147,/home/yww/CAS^3/new_data_full_reduce/147/e,Macro,1,287,336,3083,49
147,/home/yww/CAS^3/new_data_full_reduce/147/e,Macro,1,1888,1977,3083,89
147,/home/yww/CAS^3/new_data_full_reduce/147/e,Macro,1,2506,2534,3083,28
147,/home/yww/CAS^3/new_data_full_reduce/147/e,Micro,2,1052,1065,3083,13
147,/home/yww/CAS^3/new_data_full_reduce/147/g,Macro,1,50,148,2742,98
147,/home/yww/CAS^3/new_data_full_reduce/147/g,Macro,1,156,195,2742,39
147,/home/yww/CAS^3/new_data_full_reduce/147/g,Macro,1,984,1029,2742,45
147,/home/yww/CAS^3/new_data_full_reduce/147/g,Macro,1,2034,2088,2742,54
147,/home/yww/CAS^3/new_data_full_reduce/147/h,Macro,1,2515,2612,3506,97
147,/home/yww/CAS^3/new_data_full_reduce/147/h,Macro,1,2774,2813,3506,39
147,/home/yww/CAS^3/new_data_full_reduce/147/i,Macro,1,2780,2881,4336,101
147,/home/yww/CAS^3/new_data_full_reduce/147/j,Macro,1,144,205,1998,61
147,/home/yww/CAS^3/new_data_full_reduce/147/j,Macro,1,440,467,1998,27
147,/home/yww/CAS^3/new_data_full_reduce/147/j,Macro,1,1140,1165,1998,25
147,/home/yww/CAS^3/new_data_full_reduce/147/j,Macro,1,1452,1496,1998,44
147,/home/yww/CAS^3/new_data_full_reduce/147/k,Macro,1,232,275,2772,43
147,/home/yww/CAS^3/new_data_full_reduce/147/k,Macro,1,456,549,2772,93
147,/home/yww/CAS^3/new_data_full_reduce/147/k,Macro,1,580,693,2772,113
147,/home/yww/CAS^3/new_data_full_reduce/147/l,Macro,1,2648,2683,4191,35
147,/home/yww/CAS^3/new_data_full_reduce/147/l,Macro,1,2774,2827,4191,53
147,/home/yww/CAS^3/new_data_full_reduce/147/l,Macro,1,3574,3678,4191,104
147,/home/yww/CAS^3/new_data_full_reduce/147/l,Macro,1,4141,4167,4191,26
147,/home/yww/CAS^3/new_data_full_reduce/147/l,Macro,1,4174,4190,4191,16
147,/home/yww/CAS^3/new_data_full_reduce/147/m,Macro,1,2,59,2889,57
147,/home/yww/CAS^3/new_data_full_reduce/147/m,Macro,1,2492,2580,2889,88
148,/home/yww/CAS^3/new_data_full_reduce/148/a,Macro,1,102,139,1019,37
148,/home/yww/CAS^3/new_data_full_reduce/148/a,Macro,1,263,324,1019,61
148,/home/yww/CAS^3/new_data_full_reduce/148/b,Macro,1,361,413,1265,52
148,/home/yww/CAS^3/new_data_full_reduce/148/b,Micro,2,200,214,1265,14
148,/home/yww/CAS^3/new_data_full_reduce/148/b,Micro,2,283,291,1265,8
148,/home/yww/CAS^3/new_data_full_reduce/148/b,Micro,2,332,344,1265,12
148,/home/yww/CAS^3/new_data_full_reduce/148/b,Micro,2,807,816,1265,9
148,/home/yww/CAS^3/new_data_full_reduce/148/c,Macro,1,537,571,3470,34
148,/home/yww/CAS^3/new_data_full_reduce/148/c,Micro,2,155,168,3470,13
148,/home/yww/CAS^3/new_data_full_reduce/148/c,Micro,2,2290,2302,3470,12
148,/home/yww/CAS^3/new_data_full_reduce/148/d,Macro,1,496,528,4816,32
148,/home/yww/CAS^3/new_data_full_reduce/148/d,Macro,1,2109,2127,4816,18
148,/home/yww/CAS^3/new_data_full_reduce/148/d,Macro,1,2694,2769,4816,75
148,/home/yww/CAS^3/new_data_full_reduce/148/d,Micro,2,1893,1903,4816,10
148,/home/yww/CAS^3/new_data_full_reduce/148/d,Micro,2,2255,2266,4816,11
148,/home/yww/CAS^3/new_data_full_reduce/148/d,Micro,2,2651,2659,4816,8
148,/home/yww/CAS^3/new_data_full_reduce/148/d,Micro,2,2662,2674,4816,12
148,/home/yww/CAS^3/new_data_full_reduce/148/e,Macro,1,1006,1052,3081,46
148,/home/yww/CAS^3/new_data_full_reduce/148/e,Macro,1,1423,1503,3081,80
148,/home/yww/CAS^3/new_data_full_reduce/148/e,Macro,1,1753,1775,3081,22
148,/home/yww/CAS^3/new_data_full_reduce/148/e,Macro,1,1867,1933,3081,66
148,/home/yww/CAS^3/new_data_full_reduce/148/e,Macro,1,1992,2025,3081,33
148,/home/yww/CAS^3/new_data_full_reduce/148/e,Micro,2,877,892,3081,15
148,/home/yww/CAS^3/new_data_full_reduce/148/f,Macro,1,222,248,2308,26
148,/home/yww/CAS^3/new_data_full_reduce/148/f,Macro,1,993,1099,2308,106
148,/home/yww/CAS^3/new_data_full_reduce/148/f,Macro,1,1310,1349,2308,39
148,/home/yww/CAS^3/new_data_full_reduce/148/f,Micro,2,591,601,2308,10
148,/home/yww/CAS^3/new_data_full_reduce/148/f,Micro,2,792,801,2308,9
148,/home/yww/CAS^3/new_data_full_reduce/148/f,Micro,2,1379,1390,2308,11
148,/home/yww/CAS^3/new_data_full_reduce/148/f,Micro,2,1458,1468,2308,10
148,/home/yww/CAS^3/new_data_full_reduce/148/g,Macro,1,937,1042,2739,105
148,/home/yww/CAS^3/new_data_full_reduce/148/g,Macro,1,1975,2004,2739,29
148,/home/yww/CAS^3/new_data_full_reduce/148/g,Macro,1,2032,2088,2739,56
148,/home/yww/CAS^3/new_data_full_reduce/148/g,Macro,1,2103,2155,2739,52
148,/home/yww/CAS^3/new_data_full_reduce/148/g,Macro,1,2680,2720,2739,40
148,/home/yww/CAS^3/new_data_full_reduce/148/h,Macro,1,1258,1308,3506,50
148,/home/yww/CAS^3/new_data_full_reduce/148/i,Macro,1,437,522,4335,85
148,/home/yww/CAS^3/new_data_full_reduce/148/i,Macro,1,1390,1487,4335,97
148,/home/yww/CAS^3/new_data_full_reduce/148/i,Macro,1,3277,3379,4335,102
148,/home/yww/CAS^3/new_data_full_reduce/148/i,Micro,2,129,143,4335,14
148,/home/yww/CAS^3/new_data_full_reduce/148/k,Macro,1,2675,2738,2774,63
148,/home/yww/CAS^3/new_data_full_reduce/148/k,Micro,2,2584,2593,2774,9
148,/home/yww/CAS^3/new_data_full_reduce/148/l,Macro,1,504,571,4190,67
148,/home/yww/CAS^3/new_data_full_reduce/148/l,Macro,1,1239,1285,4190,46
148,/home/yww/CAS^3/new_data_full_reduce/148/l,Micro,2,1343,1358,4190,15
148,/home/yww/CAS^3/new_data_full_reduce/148/m,Macro,1,113,138,2890,25
148,/home/yww/CAS^3/new_data_full_reduce/148/m,Macro,1,517,546,2890,29
148,/home/yww/CAS^3/new_data_full_reduce/148/m,Macro,1,798,821,2890,23
148,/home/yww/CAS^3/new_data_full_reduce/148/m,Macro,1,2058,2127,2890,69
149,/home/yww/CAS^3/new_data_full_reduce/149/b,Macro,1,66,122,1232,56
149,/home/yww/CAS^3/new_data_full_reduce/149/b,Macro,1,227,252,1232,25
149,/home/yww/CAS^3/new_data_full_reduce/149/b,Macro,1,887,993,1232,106
149,/home/yww/CAS^3/new_data_full_reduce/149/b,Macro,1,1113,1221,1232,108
149,/home/yww/CAS^3/new_data_full_reduce/149/c,Macro,1,907,1008,3470,101
149,/home/yww/CAS^3/new_data_full_reduce/149/c,Macro,1,2549,2642,3470,93
149,/home/yww/CAS^3/new_data_full_reduce/149/d,Macro,1,85,104,4815,19
149,/home/yww/CAS^3/new_data_full_reduce/149/d,Macro,1,706,800,4815,94
149,/home/yww/CAS^3/new_data_full_reduce/149/d,Macro,1,3282,3399,4815,117
149,/home/yww/CAS^3/new_data_full_reduce/149/e,Macro,1,1794,1810,3082,16
149,/home/yww/CAS^3/new_data_full_reduce/149/e,Macro,1,1996,2094,3082,98
149,/home/yww/CAS^3/new_data_full_reduce/149/f,Macro,1,1519,1606,2308,87
149,/home/yww/CAS^3/new_data_full_reduce/149/g,Macro,1,364,452,2739,88
149,/home/yww/CAS^3/new_data_full_reduce/149/g,Macro,1,2048,2086,2739,38
149,/home/yww/CAS^3/new_data_full_reduce/149/g,Macro,1,2580,2653,2739,73
149,/home/yww/CAS^3/new_data_full_reduce/149/g,Macro,1,2686,2738,2739,52
149,/home/yww/CAS^3/new_data_full_reduce/149/h,Macro,1,22,99,3507,77
149,/home/yww/CAS^3/new_data_full_reduce/149/h,Macro,1,1508,1611,3507,103
149,/home/yww/CAS^3/new_data_full_reduce/149/h,Macro,1,3103,3214,3507,111
149,/home/yww/CAS^3/new_data_full_reduce/149/h,Macro,1,3298,3362,3507,64
149,/home/yww/CAS^3/new_data_full_reduce/149/i,Macro,1,475,511,4337,36
149,/home/yww/CAS^3/new_data_full_reduce/149/i,Macro,1,1735,1820,4337,85
149,/home/yww/CAS^3/new_data_full_reduce/149/i,Macro,1,2038,2131,4337,93
149,/home/yww/CAS^3/new_data_full_reduce/149/i,Micro,2,1822,1829,4337,7
149,/home/yww/CAS^3/new_data_full_reduce/149/i,Micro,2,1844,1857,4337,13
149,/home/yww/CAS^3/new_data_full_reduce/149/j,Macro,1,545,590,1997,45
149,/home/yww/CAS^3/new_data_full_reduce/149/j,Macro,1,626,670,1997,44
149,/home/yww/CAS^3/new_data_full_reduce/149/k,Macro,1,149,268,2773,119
149,/home/yww/CAS^3/new_data_full_reduce/149/k,Macro,1,1014,1126,2773,112
149,/home/yww/CAS^3/new_data_full_reduce/149/l,Macro,1,39,90,4189,51
149,/home/yww/CAS^3/new_data_full_reduce/149/l,Macro,1,826,939,4189,113
149,/home/yww/CAS^3/new_data_full_reduce/149/l,Macro,1,3263,3331,4189,68
149,/home/yww/CAS^3/new_data_full_reduce/149/l,Macro,1,3998,4052,4189,54
149,/home/yww/CAS^3/new_data_full_reduce/149/m,Macro,1,647,718,2888,71
149,/home/yww/CAS^3/new_data_full_reduce/149/m,Macro,1,2715,2818,2888,103
150,/home/yww/CAS^3/new_data_full_reduce/150/a,Macro,1,79,132,1020,53
150,/home/yww/CAS^3/new_data_full_reduce/150/a,Macro,1,552,609,1020,57
150,/home/yww/CAS^3/new_data_full_reduce/150/c,Macro,1,833,855,3469,22
150,/home/yww/CAS^3/new_data_full_reduce/150/c,Micro,2,1978,1988,3469,10
150,/home/yww/CAS^3/new_data_full_reduce/150/d,Macro,1,899,939,4816,40
150,/home/yww/CAS^3/new_data_full_reduce/150/d,Macro,1,986,1023,4816,37
150,/home/yww/CAS^3/new_data_full_reduce/150/d,Macro,1,1548,1601,4816,53
150,/home/yww/CAS^3/new_data_full_reduce/150/d,Macro,1,3326,3362,4816,36
150,/home/yww/CAS^3/new_data_full_reduce/150/d,Macro,1,4261,4312,4816,51
150,/home/yww/CAS^3/new_data_full_reduce/150/e,Macro,1,1,66,3083,65
150,/home/yww/CAS^3/new_data_full_reduce/150/e,Macro,1,1904,1950,3083,46
150,/home/yww/CAS^3/new_data_full_reduce/150/e,Micro,2,2271,2276,3083,5
150,/home/yww/CAS^3/new_data_full_reduce/150/f,Macro,1,801,839,2309,38
150,/home/yww/CAS^3/new_data_full_reduce/150/f,Macro,1,1349,1400,2309,51
150,/home/yww/CAS^3/new_data_full_reduce/150/f,Micro,2,2029,2043,2309,14
150,/home/yww/CAS^3/new_data_full_reduce/150/f,Micro,2,2074,2089,2309,15
150,/home/yww/CAS^3/new_data_full_reduce/150/f,Micro,2,2125,2140,2309,15
150,/home/yww/CAS^3/new_data_full_reduce/150/g,Macro,1,762,793,2740,31
150,/home/yww/CAS^3/new_data_full_reduce/150/h,Macro,1,2232,2266,3506,34
150,/home/yww/CAS^3/new_data_full_reduce/150/h,Macro,1,3060,3099,3506,39
150,/home/yww/CAS^3/new_data_full_reduce/150/i,Macro,1,1074,1112,4334,38
150,/home/yww/CAS^3/new_data_full_reduce/150/i,Macro,1,2643,2722,4334,79
150,/home/yww/CAS^3/new_data_full_reduce/150/i,Macro,1,3244,3282,4334,38
150,/home/yww/CAS^3/new_data_full_reduce/150/j,Macro,1,393,448,2002,55
150,/home/yww/CAS^3/new_data_full_reduce/150/j,Macro,1,1957,2000,2002,43
150,/home/yww/CAS^3/new_data_full_reduce/150/j,Micro,2,744,757,2002,13
150,/home/yww/CAS^3/new_data_full_reduce/150/j,Micro,2,1725,1740,2002,15
150,/home/yww/CAS^3/new_data_full_reduce/150/l,Macro,1,225,246,4189,21
150,/home/yww/CAS^3/new_data_full_reduce/150/l,Macro,1,2325,2435,4189,110
150,/home/yww/CAS^3/new_data_full_reduce/150/m,Macro,1,224,294,2891,70
150,/home/yww/CAS^3/new_data_full_reduce/150/m,Macro,1,341,400,2891,59
151,/home/yww/CAS^3/new_data_full_reduce/151/c,Macro,1,2802,2904,3471,102
151,/home/yww/CAS^3/new_data_full_reduce/151/d,Macro,1,2065,2154,4816,89
151,/home/yww/CAS^3/new_data_full_reduce/151/d,Macro,1,4633,4709,4816,76
151,/home/yww/CAS^3/new_data_full_reduce/151/e,Macro,1,410,452,3079,42
151,/home/yww/CAS^3/new_data_full_reduce/151/e,Macro,1,1577,1675,3079,98
151,/home/yww/CAS^3/new_data_full_reduce/151/g,Macro,1,343,396,2741,53
151,/home/yww/CAS^3/new_data_full_reduce/151/g,Macro,1,2648,2739,2741,91
151,/home/yww/CAS^3/new_data_full_reduce/151/h,Macro,1,479,576,3505,97
151,/home/yww/CAS^3/new_data_full_reduce/151/h,Macro,1,2435,2551,3505,116
151,/home/yww/CAS^3/new_data_full_reduce/151/i,Macro,1,1,99,4337,98
151,/home/yww/CAS^3/new_data_full_reduce/151/i,Macro,1,1858,1938,4337,80
151,/home/yww/CAS^3/new_data_full_reduce/151/i,Macro,1,2709,2798,4337,89
151,/home/yww/CAS^3/new_data_full_reduce/151/i,Macro,1,4060,4118,4337,58
152,/home/yww/CAS^3/new_data_full_reduce/152/c,Micro,2,1532,1543,3468,11
152,/home/yww/CAS^3/new_data_full_reduce/152/d,Macro,1,31,76,4816,45
152,/home/yww/CAS^3/new_data_full_reduce/152/d,Macro,1,1631,1697,4816,66
152,/home/yww/CAS^3/new_data_full_reduce/152/d,Macro,1,2423,2512,4816,89
152,/home/yww/CAS^3/new_data_full_reduce/152/d,Macro,1,2559,2601,4816,42
152,/home/yww/CAS^3/new_data_full_reduce/152/d,Macro,1,2681,2782,4816,101
152,/home/yww/CAS^3/new_data_full_reduce/152/d,Macro,1,3757,3824,4816,67
152,/home/yww/CAS^3/new_data_full_reduce/152/d,Macro,1,3944,4043,4816,99
152,/home/yww/CAS^3/new_data_full_reduce/152/d,Macro,1,4081,4160,4816,79
152,/home/yww/CAS^3/new_data_full_reduce/152/d,Macro,1,4279,4370,4816,91
152,/home/yww/CAS^3/new_data_full_reduce/152/d,Micro,2,2550,2559,4816,9
152,/home/yww/CAS^3/new_data_full_reduce/152/e,Macro,1,299,353,3082,54
152,/home/yww/CAS^3/new_data_full_reduce/152/e,Macro,1,1017,1077,3082,60
152,/home/yww/CAS^3/new_data_full_reduce/152/e,Macro,1,1216,1292,3082,76
152,/home/yww/CAS^3/new_data_full_reduce/152/e,Macro,1,1886,2005,3082,119
152,/home/yww/CAS^3/new_data_full_reduce/152/e,Macro,1,2100,2216,3082,116
152,/home/yww/CAS^3/new_data_full_reduce/152/e,Macro,1,2516,2606,3082,90
152,/home/yww/CAS^3/new_data_full_reduce/152/f,Macro,1,1,41,2309,40
152,/home/yww/CAS^3/new_data_full_reduce/152/f,Macro,1,351,429,2309,78
152,/home/yww/CAS^3/new_data_full_reduce/152/f,Macro,1,454,545,2309,91
152,/home/yww/CAS^3/new_data_full_reduce/152/f,Macro,1,1259,1360,2309,101
152,/home/yww/CAS^3/new_data_full_reduce/152/f,Macro,1,1478,1569,2309,91
152,/home/yww/CAS^3/new_data_full_reduce/152/f,Micro,2,1145,1157,2309,12
152,/home/yww/CAS^3/new_data_full_reduce/152/g,Macro,1,19,76,2740,57
152,/home/yww/CAS^3/new_data_full_reduce/152/g,Macro,1,251,300,2740,49
152,/home/yww/CAS^3/new_data_full_reduce/152/g,Macro,1,1254,1319,2740,65
152,/home/yww/CAS^3/new_data_full_reduce/152/g,Macro,1,1802,1868,2740,66
152,/home/yww/CAS^3/new_data_full_reduce/152/g,Macro,1,2101,2191,2740,90
152,/home/yww/CAS^3/new_data_full_reduce/152/g,Macro,1,2532,2597,2740,65
152,/home/yww/CAS^3/new_data_full_reduce/152/g,Macro,1,2654,2723,2740,69
152,/home/yww/CAS^3/new_data_full_reduce/152/i,Macro,1,685,770,4337,85
152,/home/yww/CAS^3/new_data_full_reduce/152/i,Macro,1,905,968,4337,63
152,/home/yww/CAS^3/new_data_full_reduce/152/i,Macro,1,1008,1069,4337,61
152,/home/yww/CAS^3/new_data_full_reduce/152/i,Macro,1,1432,1517,4337,85
152,/home/yww/CAS^3/new_data_full_reduce/152/i,Macro,1,2194,2235,4337,41
152,/home/yww/CAS^3/new_data_full_reduce/152/i,Micro,2,114,118,4337,4
152,/home/yww/CAS^3/new_data_full_reduce/152/j,Macro,1,360,458,1997,98
152,/home/yww/CAS^3/new_data_full_reduce/152/j,Macro,1,721,772,1997,51
152,/home/yww/CAS^3/new_data_full_reduce/152/j,Macro,1,772,816,1997,44
152,/home/yww/CAS^3/new_data_full_reduce/152/j,Macro,1,872,973,1997,101
152,/home/yww/CAS^3/new_data_full_reduce/152/j,Macro,1,989,1102,1997,113
152,/home/yww/CAS^3/new_data_full_reduce/152/j,Macro,1,1120,1188,1997,68
152,/home/yww/CAS^3/new_data_full_reduce/152/j,Macro,1,1370,1407,1997,37
152,/home/yww/CAS^3/new_data_full_reduce/152/j,Macro,1,1570,1601,1997,31
152,/home/yww/CAS^3/new_data_full_reduce/152/j,Macro,1,1660,1692,1997,32
152,/home/yww/CAS^3/new_data_full_reduce/152/k,Macro,1,31,100,2772,69
152,/home/yww/CAS^3/new_data_full_reduce/152/k,Macro,1,923,1015,2772,92
152,/home/yww/CAS^3/new_data_full_reduce/152/k,Macro,1,1969,2039,2772,70
152,/home/yww/CAS^3/new_data_full_reduce/152/l,Macro,1,394,503,4164,109
152,/home/yww/CAS^3/new_data_full_reduce/152/l,Macro,1,1058,1110,4164,52
152,/home/yww/CAS^3/new_data_full_reduce/152/l,Macro,1,1110,1179,4164,69
152,/home/yww/CAS^3/new_data_full_reduce/152/l,Macro,1,1262,1339,4164,77
152,/home/yww/CAS^3/new_data_full_reduce/152/l,Macro,1,1341,1410,4164,69
152,/home/yww/CAS^3/new_data_full_reduce/152/m,Macro,1,477,566,2889,89
152,/home/yww/CAS^3/new_data_full_reduce/152/m,Macro,1,1750,1835,2889,85
153,/home/yww/CAS^3/new_data_full_reduce/153/a,Macro,1,102,125,1018,23
153,/home/yww/CAS^3/new_data_full_reduce/153/a,Macro,1,939,1007,1018,68
153,/home/yww/CAS^3/new_data_full_reduce/153/b,Macro,1,940,983,1264,43
153,/home/yww/CAS^3/new_data_full_reduce/153/c,Macro,1,1,77,3473,76
153,/home/yww/CAS^3/new_data_full_reduce/153/c,Macro,1,2088,2174,3473,86
153,/home/yww/CAS^3/new_data_full_reduce/153/d,Macro,1,1365,1453,4818,88
153,/home/yww/CAS^3/new_data_full_reduce/153/d,Macro,1,3704,3816,4818,112
153,/home/yww/CAS^3/new_data_full_reduce/153/e,Macro,1,1106,1185,3082,79
153,/home/yww/CAS^3/new_data_full_reduce/153/f,Macro,1,333,417,2311,84
153,/home/yww/CAS^3/new_data_full_reduce/153/h,Micro,2,2013,2026,3506,13
153,/home/yww/CAS^3/new_data_full_reduce/153/j,Macro,1,411,471,1997,60
153,/home/yww/CAS^3/new_data_full_reduce/153/j,Macro,1,917,946,1997,29
153,/home/yww/CAS^3/new_data_full_reduce/153/j,Micro,2,268,282,1997,14
153,/home/yww/CAS^3/new_data_full_reduce/153/j,Micro,2,1567,1580,1997,13
153,/home/yww/CAS^3/new_data_full_reduce/153/m,Macro,1,172,245,2889,73
153,/home/yww/CAS^3/new_data_full_reduce/153/m,Macro,1,2130,2173,2889,43
154,/home/yww/CAS^3/new_data_full_reduce/154/d,Macro,1,3952,3981,4818,29
154,/home/yww/CAS^3/new_data_full_reduce/154/g,Macro,1,193,310,2742,117
154,/home/yww/CAS^3/new_data_full_reduce/154/h,Macro,1,127,241,3504,114
154,/home/yww/CAS^3/new_data_full_reduce/154/i,Macro,1,1503,1577,4327,74
154,/home/yww/CAS^3/new_data_full_reduce/154/i,Macro,1,2219,2278,4327,59
154,/home/yww/CAS^3/new_data_full_reduce/154/i,Macro,1,2481,2497,4327,16
155,/home/yww/CAS^3/new_data_full_reduce/155/a,Macro,1,241,259,1019,18
155,/home/yww/CAS^3/new_data_full_reduce/155/a,Macro,1,295,344,1019,49
155,/home/yww/CAS^3/new_data_full_reduce/155/b,Macro,1,1,42,1267,41
155,/home/yww/CAS^3/new_data_full_reduce/155/b,Macro,1,196,288,1267,92
155,/home/yww/CAS^3/new_data_full_reduce/155/b,Macro,1,527,575,1267,48
155,/home/yww/CAS^3/new_data_full_reduce/155/c,Macro,1,824,865,3471,41
155,/home/yww/CAS^3/new_data_full_reduce/155/e,Macro,1,159,180,3080,21
155,/home/yww/CAS^3/new_data_full_reduce/155/e,Macro,1,885,985,3080,100
155,/home/yww/CAS^3/new_data_full_reduce/155/e,Macro,1,2509,2595,3080,86
155,/home/yww/CAS^3/new_data_full_reduce/155/h,Macro,1,3108,3207,3507,99
156,/home/yww/CAS^3/new_data_full_reduce/156/a,Macro,1,278,310,1019,32
156,/home/yww/CAS^3/new_data_full_reduce/156/a,Micro,2,28,40,1019,12
156,/home/yww/CAS^3/new_data_full_reduce/156/b,Micro,2,32,44,1267,12
156,/home/yww/CAS^3/new_data_full_reduce/156/b,Micro,2,92,104,1267,12
156,/home/yww/CAS^3/new_data_full_reduce/156/b,Micro,2,175,183,1267,8
156,/home/yww/CAS^3/new_data_full_reduce/156/b,Micro,2,365,372,1267,7
156,/home/yww/CAS^3/new_data_full_reduce/156/c,Micro,2,86,97,3472,11
156,/home/yww/CAS^3/new_data_full_reduce/156/c,Micro,2,2179,2189,3472,10
156,/home/yww/CAS^3/new_data_full_reduce/156/d,Micro,2,197,210,4818,13
156,/home/yww/CAS^3/new_data_full_reduce/156/d,Micro,2,1110,1125,4818,15
156,/home/yww/CAS^3/new_data_full_reduce/156/d,Micro,2,4673,4687,4818,14
156,/home/yww/CAS^3/new_data_full_reduce/156/g,Macro,1,149,185,2740,36
156,/home/yww/CAS^3/new_data_full_reduce/156/i,Macro,1,4180,4225,4336,45
156,/home/yww/CAS^3/new_data_full_reduce/156/j,Macro,1,11,42,1999,31
156,/home/yww/CAS^3/new_data_full_reduce/156/j,Macro,1,784,841,1999,57
156,/home/yww/CAS^3/new_data_full_reduce/156/j,Macro,1,1197,1218,1999,21
156,/home/yww/CAS^3/new_data_full_reduce/156/j,Macro,1,1424,1538,1999,114
156,/home/yww/CAS^3/new_data_full_reduce/156/j,Macro,1,1598,1714,1999,116
156,/home/yww/CAS^3/new_data_full_reduce/156/l,Macro,1,3852,3869,4191,17
156,/home/yww/CAS^3/new_data_full_reduce/156/l,Micro,2,99,107,4191,8
157,/home/yww/CAS^3/new_data_full_reduce/157/a,Macro,1,290,409,1019,119
157,/home/yww/CAS^3/new_data_full_reduce/157/a,Macro,1,975,1018,1019,43
157,/home/yww/CAS^3/new_data_full_reduce/157/b,Macro,1,1,69,1267,68
157,/home/yww/CAS^3/new_data_full_reduce/157/c,Macro,1,19,45,3473,26
157,/home/yww/CAS^3/new_data_full_reduce/157/d,Macro,1,2904,2976,4817,72
157,/home/yww/CAS^3/new_data_full_reduce/157/d,Macro,1,4221,4242,4817,21
157,/home/yww/CAS^3/new_data_full_reduce/157/d,Macro,1,4387,4497,4817,110
157,/home/yww/CAS^3/new_data_full_reduce/157/d,Micro,2,2499,2508,4817,9
157,/home/yww/CAS^3/new_data_full_reduce/157/g,Macro,1,1250,1272,2742,22
157,/home/yww/CAS^3/new_data_full_reduce/157/g,Macro,1,2147,2256,2742,109
157,/home/yww/CAS^3/new_data_full_reduce/157/h,Macro,1,107,128,3509,21
157,/home/yww/CAS^3/new_data_full_reduce/157/h,Macro,1,338,397,3509,59
157,/home/yww/CAS^3/new_data_full_reduce/157/j,Macro,1,1831,1923,1997,92
157,/home/yww/CAS^3/new_data_full_reduce/157/k,Macro,1,108,145,2773,37
157,/home/yww/CAS^3/new_data_full_reduce/157/k,Macro,1,1256,1328,2773,72
157,/home/yww/CAS^3/new_data_full_reduce/157/k,Macro,1,2486,2599,2773,113
157,/home/yww/CAS^3/new_data_full_reduce/157/l,Macro,1,31,113,4189,82
157,/home/yww/CAS^3/new_data_full_reduce/157/l,Macro,1,2845,2931,4189,86
157,/home/yww/CAS^3/new_data_full_reduce/157/l,Macro,1,3088,3116,4189,28
157,/home/yww/CAS^3/new_data_full_reduce/157/l,Micro,2,2532,2547,4189,15
157,/home/yww/CAS^3/new_data_full_reduce/157/m,Macro,1,1,80,2888,79
158,/home/yww/CAS^3/new_data_full_reduce/158/a,Macro,1,656,706,1019,50
158,/home/yww/CAS^3/new_data_full_reduce/158/a,Macro,1,715,758,1019,43
158,/home/yww/CAS^3/new_data_full_reduce/158/a,Macro,1,947,1017,1019,70
158,/home/yww/CAS^3/new_data_full_reduce/158/d,Macro,1,40,133,4817,93
158,/home/yww/CAS^3/new_data_full_reduce/158/d,Macro,1,2664,2704,4817,40
158,/home/yww/CAS^3/new_data_full_reduce/158/d,Macro,1,2753,2841,4817,88
158,/home/yww/CAS^3/new_data_full_reduce/158/d,Macro,1,3914,3940,4817,26
158,/home/yww/CAS^3/new_data_full_reduce/158/e,Macro,1,436,544,3083,108
158,/home/yww/CAS^3/new_data_full_reduce/158/e,Macro,1,549,666,3083,117
158,/home/yww/CAS^3/new_data_full_reduce/158/e,Micro,2,39,51,3083,12
158,/home/yww/CAS^3/new_data_full_reduce/158/f,Macro,1,45,69,2310,24
158,/home/yww/CAS^3/new_data_full_reduce/158/f,Macro,1,2182,2211,2310,29
158,/home/yww/CAS^3/new_data_full_reduce/158/g,Macro,1,65,113,2738,48
158,/home/yww/CAS^3/new_data_full_reduce/158/g,Macro,1,1758,1867,2738,109
158,/home/yww/CAS^3/new_data_full_reduce/158/h,Macro,1,18,90,3508,72
158,/home/yww/CAS^3/new_data_full_reduce/158/i,Macro,1,382,426,4337,44
158,/home/yww/CAS^3/new_data_full_reduce/158/k,Macro,1,2748,2770,2772,22
159,/home/yww/CAS^3/new_data_full_reduce/159/a,Macro,1,46,95,1019,49
159,/home/yww/CAS^3/new_data_full_reduce/159/c,Macro,1,2901,2935,3469,34
159,/home/yww/CAS^3/new_data_full_reduce/159/c,Macro,1,3391,3468,3469,77
160,/home/yww/CAS^3/new_data_full_reduce/160/a,Macro,1,948,1017,1018,69
160,/home/yww/CAS^3/new_data_full_reduce/160/b,Macro,1,8,40,1267,32
160,/home/yww/CAS^3/new_data_full_reduce/160/b,Macro,1,144,190,1267,46
160,/home/yww/CAS^3/new_data_full_reduce/160/b,Macro,1,410,503,1267,93
160,/home/yww/CAS^3/new_data_full_reduce/160/b,Macro,1,917,986,1267,69
160,/home/yww/CAS^3/new_data_full_reduce/160/c,Macro,1,120,166,3469,46
160,/home/yww/CAS^3/new_data_full_reduce/160/c,Macro,1,769,798,3469,29
160,/home/yww/CAS^3/new_data_full_reduce/160/c,Macro,1,904,923,3469,19
160,/home/yww/CAS^3/new_data_full_reduce/160/c,Macro,1,1016,1071,3469,55
160,/home/yww/CAS^3/new_data_full_reduce/160/c,Macro,1,1222,1294,3469,72
160,/home/yww/CAS^3/new_data_full_reduce/160/c,Macro,1,2178,2243,3469,65
160,/home/yww/CAS^3/new_data_full_reduce/160/c,Macro,1,3047,3136,3469,89
160,/home/yww/CAS^3/new_data_full_reduce/160/c,Macro,1,3441,3468,3469,27
160,/home/yww/CAS^3/new_data_full_reduce/160/c,Micro,2,2279,2294,3469,15
160,/home/yww/CAS^3/new_data_full_reduce/160/d,Macro,1,1509,1529,4819,20
160,/home/yww/CAS^3/new_data_full_reduce/160/d,Macro,1,1539,1571,4819,32
160,/home/yww/CAS^3/new_data_full_reduce/160/d,Macro,1,2206,2265,4819,59
160,/home/yww/CAS^3/new_data_full_reduce/160/d,Macro,1,3001,3025,4819,24
160,/home/yww/CAS^3/new_data_full_reduce/160/d,Macro,1,3059,3089,4819,30
160,/home/yww/CAS^3/new_data_full_reduce/160/d,Macro,1,3377,3469,4819,92
160,/home/yww/CAS^3/new_data_full_reduce/160/d,Macro,1,4146,4215,4819,69
160,/home/yww/CAS^3/new_data_full_reduce/160/d,Micro,2,536,544,4819,8
160,/home/yww/CAS^3/new_data_full_reduce/160/d,Micro,2,968,982,4819,14
160,/home/yww/CAS^3/new_data_full_reduce/160/d,Micro,2,1193,1202,4819,9
160,/home/yww/CAS^3/new_data_full_reduce/160/d,Micro,2,1491,1499,4819,8
160,/home/yww/CAS^3/new_data_full_reduce/160/d,Micro,2,3028,3043,4819,15
160,/home/yww/CAS^3/new_data_full_reduce/160/d,Micro,2,4070,4082,4819,12
160,/home/yww/CAS^3/new_data_full_reduce/160/e,Macro,1,25,95,3083,70
160,/home/yww/CAS^3/new_data_full_reduce/160/e,Macro,1,109,188,3083,79
160,/home/yww/CAS^3/new_data_full_reduce/160/e,Macro,1,318,337,3083,19
160,/home/yww/CAS^3/new_data_full_reduce/160/e,Macro,1,368,403,3083,35
160,/home/yww/CAS^3/new_data_full_reduce/160/e,Macro,1,500,553,3083,53
160,/home/yww/CAS^3/new_data_full_reduce/160/e,Macro,1,855,879,3083,24
160,/home/yww/CAS^3/new_data_full_reduce/160/e,Macro,1,1549,1586,3083,37
160,/home/yww/CAS^3/new_data_full_reduce/160/e,Macro,1,1955,2036,3083,81
160,/home/yww/CAS^3/new_data_full_reduce/160/e,Macro,1,2070,2088,3083,18
160,/home/yww/CAS^3/new_data_full_reduce/160/e,Macro,1,2109,2226,3083,117
160,/home/yww/CAS^3/new_data_full_reduce/160/e,Macro,1,2957,3045,3083,88
160,/home/yww/CAS^3/new_data_full_reduce/160/e,Micro,2,337,345,3083,8
160,/home/yww/CAS^3/new_data_full_reduce/160/e,Micro,2,455,465,3083,10
160,/home/yww/CAS^3/new_data_full_reduce/160/e,Micro,2,582,593,3083,11
160,/home/yww/CAS^3/new_data_full_reduce/160/e,Micro,2,884,896,3083,12
160,/home/yww/CAS^3/new_data_full_reduce/160/e,Micro,2,1429,1443,3083,14
160,/home/yww/CAS^3/new_data_full_reduce/160/e,Micro,2,1527,1539,3083,12
160,/home/yww/CAS^3/new_data_full_reduce/160/e,Micro,2,1745,1754,3083,9
160,/home/yww/CAS^3/new_data_full_reduce/160/e,Micro,2,2565,2576,3083,11
160,/home/yww/CAS^3/new_data_full_reduce/160/f,Macro,1,903,986,2311,83
160,/home/yww/CAS^3/new_data_full_reduce/160/f,Macro,1,1136,1230,2311,94
160,/home/yww/CAS^3/new_data_full_reduce/160/f,Macro,1,1454,1534,2311,80
160,/home/yww/CAS^3/new_data_full_reduce/160/f,Macro,1,1748,1819,2311,71
160,/home/yww/CAS^3/new_data_full_reduce/160/f,Macro,1,2247,2310,2311,63
160,/home/yww/CAS^3/new_data_full_reduce/160/g,Macro,1,401,432,2740,31
160,/home/yww/CAS^3/new_data_full_reduce/160/g,Macro,1,850,903,2740,53
160,/home/yww/CAS^3/new_data_full_reduce/160/g,Macro,1,1704,1775,2740,71
160,/home/yww/CAS^3/new_data_full_reduce/160/h,Macro,1,230,312,3508,82
160,/home/yww/CAS^3/new_data_full_reduce/160/h,Macro,1,952,991,3508,39
160,/home/yww/CAS^3/new_data_full_reduce/160/h,Macro,1,1155,1193,3508,38
160,/home/yww/CAS^3/new_data_full_reduce/160/h,Macro,1,1252,1358,3508,106
160,/home/yww/CAS^3/new_data_full_reduce/160/h,Macro,1,2294,2378,3508,84
160,/home/yww/CAS^3/new_data_full_reduce/160/h,Macro,1,2402,2477,3508,75
160,/home/yww/CAS^3/new_data_full_reduce/160/h,Macro,1,3136,3236,3508,100
160,/home/yww/CAS^3/new_data_full_reduce/160/h,Micro,2,475,488,3508,13
160,/home/yww/CAS^3/new_data_full_reduce/160/i,Macro,1,1333,1361,4335,28
160,/home/yww/CAS^3/new_data_full_reduce/160/i,Macro,1,2352,2403,4335,51
160,/home/yww/CAS^3/new_data_full_reduce/160/i,Macro,1,2449,2518,4335,69
160,/home/yww/CAS^3/new_data_full_reduce/160/i,Macro,1,2533,2579,4335,46
160,/home/yww/CAS^3/new_data_full_reduce/160/i,Macro,1,3137,3170,4335,33
160,/home/yww/CAS^3/new_data_full_reduce/160/i,Macro,1,4039,4140,4335,101
160,/home/yww/CAS^3/new_data_full_reduce/160/i,Micro,2,1266,1277,4335,11
160,/home/yww/CAS^3/new_data_full_reduce/160/i,Micro,2,1307,1317,4335,10
160,/home/yww/CAS^3/new_data_full_reduce/160/i,Micro,2,1758,1769,4335,11
160,/home/yww/CAS^3/new_data_full_reduce/160/i,Micro,2,1936,1951,4335,15
160,/home/yww/CAS^3/new_data_full_reduce/160/i,Micro,2,3170,3183,4335,13
160,/home/yww/CAS^3/new_data_full_reduce/160/i,Micro,2,3399,3414,4335,15
160,/home/yww/CAS^3/new_data_full_reduce/160/i,Micro,2,3981,3993,4335,12
160,/home/yww/CAS^3/new_data_full_reduce/160/i,Micro,2,4156,4171,4335,15
160,/home/yww/CAS^3/new_data_full_reduce/160/j,Macro,1,296,333,1996,37
160,/home/yww/CAS^3/new_data_full_reduce/160/j,Macro,1,454,501,1996,47
160,/home/yww/CAS^3/new_data_full_reduce/160/j,Macro,1,1582,1612,1996,30
160,/home/yww/CAS^3/new_data_full_reduce/160/j,Micro,2,1617,1628,1996,11
160,/home/yww/CAS^3/new_data_full_reduce/160/k,Macro,1,64,184,2774,120
160,/home/yww/CAS^3/new_data_full_reduce/160/k,Macro,1,2296,2394,2774,98
160,/home/yww/CAS^3/new_data_full_reduce/160/l,Macro,1,916,941,4191,25
160,/home/yww/CAS^3/new_data_full_reduce/160/l,Macro,1,1363,1434,4191,71
160,/home/yww/CAS^3/new_data_full_reduce/160/l,Macro,1,2877,2920,4191,43
160,/home/yww/CAS^3/new_data_full_reduce/160/l,Macro,1,2972,3008,4191,36
160,/home/yww/CAS^3/new_data_full_reduce/160/l,Micro,2,73,87,4191,14
160,/home/yww/CAS^3/new_data_full_reduce/160/l,Micro,2,1272,1285,4191,13
160,/home/yww/CAS^3/new_data_full_reduce/160/m,Macro,1,55,154,2889,99
160,/home/yww/CAS^3/new_data_full_reduce/160/m,Macro,1,180,223,2889,43
160,/home/yww/CAS^3/new_data_full_reduce/160/m,Macro,1,309,429,2889,120
160,/home/yww/CAS^3/new_data_full_reduce/160/m,Macro,1,556,639,2889,83
160,/home/yww/CAS^3/new_data_full_reduce/160/m,Macro,1,1015,1113,2889,98
160,/home/yww/CAS^3/new_data_full_reduce/160/m,Macro,1,1460,1501,2889,41
160,/home/yww/CAS^3/new_data_full_reduce/160/m,Macro,1,1578,1654,2889,76
160,/home/yww/CAS^3/new_data_full_reduce/160/m,Macro,1,1728,1762,2889,34
160,/home/yww/CAS^3/new_data_full_reduce/160/m,Macro,1,1975,2025,2889,50
160,/home/yww/CAS^3/new_data_full_reduce/160/m,Macro,1,2726,2776,2889,50
160,/home/yww/CAS^3/new_data_full_reduce/160/m,Macro,1,2783,2820,2889,37
160,/home/yww/CAS^3/new_data_full_reduce/160/m,Micro,2,29,42,2889,13
161,/home/yww/CAS^3/new_data_full_reduce/161/b,Macro,1,295,392,1265,97
161,/home/yww/CAS^3/new_data_full_reduce/161/c,Macro,1,1556,1637,3470,81
161,/home/yww/CAS^3/new_data_full_reduce/161/d,Macro,1,4557,4597,4819,40
161,/home/yww/CAS^3/new_data_full_reduce/161/e,Macro,1,101,207,3083,106
161,/home/yww/CAS^3/new_data_full_reduce/161/e,Macro,1,229,277,3083,48
161,/home/yww/CAS^3/new_data_full_reduce/161/f,Macro,1,2019,2056,2300,37
161,/home/yww/CAS^3/new_data_full_reduce/161/g,Macro,1,893,923,2739,30
161,/home/yww/CAS^3/new_data_full_reduce/161/h,Macro,1,174,249,3506,75
161,/home/yww/CAS^3/new_data_full_reduce/161/h,Macro,1,1807,1835,3506,28
161,/home/yww/CAS^3/new_data_full_reduce/161/i,Macro,1,1,40,4336,39
161,/home/yww/CAS^3/new_data_full_reduce/161/j,Macro,1,542,641,1999,99
161,/home/yww/CAS^3/new_data_full_reduce/161/j,Macro,1,699,752,1999,53
162,/home/yww/CAS^3/new_data_full_reduce/162/a,Macro,1,1,66,1019,65
162,/home/yww/CAS^3/new_data_full_reduce/162/a,Macro,1,402,443,1019,41
162,/home/yww/CAS^3/new_data_full_reduce/162/b,Macro,1,484,514,1264,30
162,/home/yww/CAS^3/new_data_full_reduce/162/b,Macro,1,1067,1138,1264,71
162,/home/yww/CAS^3/new_data_full_reduce/162/b,Micro,2,1050,1061,1264,11
162,/home/yww/CAS^3/new_data_full_reduce/162/c,Macro,1,299,416,3469,117
162,/home/yww/CAS^3/new_data_full_reduce/162/c,Macro,1,494,512,3469,18
162,/home/yww/CAS^3/new_data_full_reduce/162/c,Macro,1,1896,1918,3469,22
162,/home/yww/CAS^3/new_data_full_reduce/162/c,Macro,1,2235,2261,3469,26
162,/home/yww/CAS^3/new_data_full_reduce/162/c,Macro,1,2464,2578,3469,114
162,/home/yww/CAS^3/new_data_full_reduce/162/c,Macro,1,3190,3212,3469,22
162,/home/yww/CAS^3/new_data_full_reduce/162/d,Macro,1,952,988,4817,36
162,/home/yww/CAS^3/new_data_full_reduce/162/d,Macro,1,2025,2116,4817,91
162,/home/yww/CAS^3/new_data_full_reduce/162/d,Macro,1,3355,3464,4817,109
162,/home/yww/CAS^3/new_data_full_reduce/162/g,Macro,1,53,156,2741,103
162,/home/yww/CAS^3/new_data_full_reduce/162/g,Macro,1,1092,1127,2741,35
162,/home/yww/CAS^3/new_data_full_reduce/162/h,Macro,1,1040,1089,3507,49
162,/home/yww/CAS^3/new_data_full_reduce/162/h,Macro,1,1293,1326,3507,33
162,/home/yww/CAS^3/new_data_full_reduce/162/h,Macro,1,3353,3403,3507,50
162,/home/yww/CAS^3/new_data_full_reduce/162/i,Macro,1,3330,3352,4336,22
162,/home/yww/CAS^3/new_data_full_reduce/162/i,Macro,1,3758,3811,4336,53
162,/home/yww/CAS^3/new_data_full_reduce/162/i,Micro,2,1656,1666,4336,10
162,/home/yww/CAS^3/new_data_full_reduce/162/i,Micro,2,4001,4009,4336,8
162,/home/yww/CAS^3/new_data_full_reduce/162/i,Micro,2,4170,4185,4336,15
162,/home/yww/CAS^3/new_data_full_reduce/162/k,Macro,1,93,211,2774,118
162,/home/yww/CAS^3/new_data_full_reduce/162/l,Macro,1,215,262,4190,47
162,/home/yww/CAS^3/new_data_full_reduce/162/m,Macro,1,16,50,2890,34
162,/home/yww/CAS^3/new_data_full_reduce/162/m,Macro,1,1265,1305,2890,40
162,/home/yww/CAS^3/new_data_full_reduce/162/m,Macro,1,1607,1712,2890,105
162,/home/yww/CAS^3/new_data_full_reduce/162/m,Macro,1,2141,2221,2890,80
162,/home/yww/CAS^3/new_data_full_reduce/162/m,Macro,1,2655,2707,2890,52
162,/home/yww/CAS^3/new_data_full_reduce/162/m,Micro,2,185,200,2890,15
163,/home/yww/CAS^3/new_data_full_reduce/163/a,Macro,1,251,337,1020,86
163,/home/yww/CAS^3/new_data_full_reduce/163/a,Macro,1,542,566,1020,24
163,/home/yww/CAS^3/new_data_full_reduce/163/a,Macro,1,954,979,1020,25
163,/home/yww/CAS^3/new_data_full_reduce/163/d,Macro,1,1,113,4818,112
163,/home/yww/CAS^3/new_data_full_reduce/163/d,Macro,1,2802,2892,4818,90
163,/home/yww/CAS^3/new_data_full_reduce/163/d,Macro,1,2892,3008,4818,116
163,/home/yww/CAS^3/new_data_full_reduce/163/d,Macro,1,3008,3114,4818,106
163,/home/yww/CAS^3/new_data_full_reduce/163/d,Macro,1,3114,3179,4818,65
163,/home/yww/CAS^3/new_data_full_reduce/163/d,Macro,1,3179,3275,4818,96
163,/home/yww/CAS^3/new_data_full_reduce/163/d,Macro,1,3275,3367,4818,92
163,/home/yww/CAS^3/new_data_full_reduce/163/d,Macro,1,3367,3476,4818,109
163,/home/yww/CAS^3/new_data_full_reduce/163/d,Macro,1,3476,3578,4818,102
163,/home/yww/CAS^3/new_data_full_reduce/163/d,Macro,1,3578,3673,4818,95
163,/home/yww/CAS^3/new_data_full_reduce/163/d,Macro,1,3673,3770,4818,97
163,/home/yww/CAS^3/new_data_full_reduce/163/d,Macro,1,3870,3942,4818,72
163,/home/yww/CAS^3/new_data_full_reduce/163/d,Macro,1,3942,4040,4818,98
163,/home/yww/CAS^3/new_data_full_reduce/163/d,Macro,1,4040,4154,4818,114
163,/home/yww/CAS^3/new_data_full_reduce/163/d,Macro,1,4154,4234,4818,80
163,/home/yww/CAS^3/new_data_full_reduce/163/d,Macro,1,4234,4312,4818,78
163,/home/yww/CAS^3/new_data_full_reduce/163/d,Macro,1,4312,4381,4818,69
163,/home/yww/CAS^3/new_data_full_reduce/163/d,Macro,1,4381,4459,4818,78
163,/home/yww/CAS^3/new_data_full_reduce/163/d,Macro,1,4459,4549,4818,90
163,/home/yww/CAS^3/new_data_full_reduce/163/d,Macro,1,4790,4816,4818,26
163,/home/yww/CAS^3/new_data_full_reduce/163/e,Macro,1,478,536,3082,58
163,/home/yww/CAS^3/new_data_full_reduce/163/e,Macro,1,747,798,3082,51
163,/home/yww/CAS^3/new_data_full_reduce/163/e,Macro,1,876,936,3082,60
163,/home/yww/CAS^3/new_data_full_reduce/163/e,Macro,1,1091,1198,3082,107
163,/home/yww/CAS^3/new_data_full_reduce/163/e,Macro,1,3008,3080,3082,72
163,/home/yww/CAS^3/new_data_full_reduce/163/g,Macro,1,1266,1303,2739,37
163,/home/yww/CAS^3/new_data_full_reduce/163/g,Macro,1,1803,1868,2739,65
163,/home/yww/CAS^3/new_data_full_reduce/163/g,Macro,1,2048,2137,2739,89
163,/home/yww/CAS^3/new_data_full_reduce/163/g,Macro,1,2137,2243,2739,106
163,/home/yww/CAS^3/new_data_full_reduce/163/g,Macro,1,2243,2321,2739,78
163,/home/yww/CAS^3/new_data_full_reduce/163/g,Macro,1,2321,2398,2739,77
163,/home/yww/CAS^3/new_data_full_reduce/163/g,Macro,1,2398,2493,2739,95
163,/home/yww/CAS^3/new_data_full_reduce/163/g,Macro,1,2493,2607,2739,114
163,/home/yww/CAS^3/new_data_full_reduce/163/j,Macro,1,171,189,2001,18
163,/home/yww/CAS^3/new_data_full_reduce/163/j,Macro,1,1271,1302,2001,31
163,/home/yww/CAS^3/new_data_full_reduce/163/k,Macro,1,1539,1577,2774,38
165,/home/yww/CAS^3/new_data_full_reduce/165/a,Macro,1,1,39,1019,38
165,/home/yww/CAS^3/new_data_full_reduce/165/b,Macro,1,444,488,1265,44
165,/home/yww/CAS^3/new_data_full_reduce/165/c,Macro,1,357,453,3469,96
165,/home/yww/CAS^3/new_data_full_reduce/165/c,Macro,1,985,1101,3469,116
165,/home/yww/CAS^3/new_data_full_reduce/165/c,Macro,1,2106,2183,3469,77
165,/home/yww/CAS^3/new_data_full_reduce/165/c,Macro,1,2187,2278,3469,91
165,/home/yww/CAS^3/new_data_full_reduce/165/c,Macro,1,2864,2917,3469,53
165,/home/yww/CAS^3/new_data_full_reduce/165/c,Macro,1,2960,2984,3469,24
165,/home/yww/CAS^3/new_data_full_reduce/165/c,Macro,1,3184,3227,3469,43
165,/home/yww/CAS^3/new_data_full_reduce/165/c,Macro,1,3309,3342,3469,33
165,/home/yww/CAS^3/new_data_full_reduce/165/c,Micro,2,443,458,3469,15
165,/home/yww/CAS^3/new_data_full_reduce/165/c,Micro,2,941,950,3469,9
165,/home/yww/CAS^3/new_data_full_reduce/165/d,Macro,1,19,54,4819,35
165,/home/yww/CAS^3/new_data_full_reduce/165/e,Macro,1,47,106,3082,59
165,/home/yww/CAS^3/new_data_full_reduce/165/e,Micro,2,3,15,3082,12
165,/home/yww/CAS^3/new_data_full_reduce/165/f,Micro,2,2083,2095,2309,12
165,/home/yww/CAS^3/new_data_full_reduce/165/g,Macro,1,41,147,2738,106
165,/home/yww/CAS^3/new_data_full_reduce/165/g,Micro,2,2535,2545,2738,10
165,/home/yww/CAS^3/new_data_full_reduce/165/j,Macro,1,1015,1108,1998,93
165,/home/yww/CAS^3/new_data_full_reduce/165/k,Macro,1,881,917,2773,36
165,/home/yww/CAS^3/new_data_full_reduce/165/k,Macro,1,1947,1991,2773,44
165,/home/yww/CAS^3/new_data_full_reduce/165/k,Micro,2,2018,2033,2773,15
165,/home/yww/CAS^3/new_data_full_reduce/165/l,Macro,1,166,259,4187,93
165,/home/yww/CAS^3/new_data_full_reduce/165/l,Macro,1,2850,2957,4187,107
165,/home/yww/CAS^3/new_data_full_reduce/165/l,Macro,1,2951,3058,4187,107
165,/home/yww/CAS^3/new_data_full_reduce/165/l,Macro,1,3075,3167,4187,92
165,/home/yww/CAS^3/new_data_full_reduce/165/l,Macro,1,3533,3596,4187,63
165,/home/yww/CAS^3/new_data_full_reduce/165/m,Macro,1,1,97,2889,96
166,/home/yww/CAS^3/new_data_full_reduce/166/e,Macro,1,95,129,3083,34
166,/home/yww/CAS^3/new_data_full_reduce/166/e,Macro,1,2474,2509,3083,35
166,/home/yww/CAS^3/new_data_full_reduce/166/i,Macro,1,799,895,4336,96
166,/home/yww/CAS^3/new_data_full_reduce/166/i,Macro,1,950,1001,4336,51
166,/home/yww/CAS^3/new_data_full_reduce/166/i,Macro,1,2193,2223,4336,30
166,/home/yww/CAS^3/new_data_full_reduce/166/i,Macro,1,2374,2415,4336,41
166,/home/yww/CAS^3/new_data_full_reduce/166/j,Macro,1,1,106,1996,105
166,/home/yww/CAS^3/new_data_full_reduce/166/j,Macro,1,113,140,1996,27
167,/home/yww/CAS^3/new_data_full_reduce/167/a,Macro,1,25,84,1019,59
167,/home/yww/CAS^3/new_data_full_reduce/167/d,Macro,1,906,968,4815,62
167,/home/yww/CAS^3/new_data_full_reduce/167/d,Macro,1,3681,3734,4815,53
167,/home/yww/CAS^3/new_data_full_reduce/167/e,Macro,1,827,860,2616,33
167,/home/yww/CAS^3/new_data_full_reduce/167/e,Macro,1,1778,1880,2616,102
167,/home/yww/CAS^3/new_data_full_reduce/167/e,Macro,1,2017,2075,2616,58
167,/home/yww/CAS^3/new_data_full_reduce/167/j,Macro,1,837,920,2001,83
167,/home/yww/CAS^3/new_data_full_reduce/167/j,Micro,2,63,78,2001,15
167,/home/yww/CAS^3/new_data_full_reduce/167/j,Micro,2,1686,1699,2001,13
167,/home/yww/CAS^3/new_data_full_reduce/167/m,Macro,1,1515,1605,2891,90
168,/home/yww/CAS^3/new_data_full_reduce/168/e,Macro,1,27,54,2031,27
168,/home/yww/CAS^3/new_data_full_reduce/168/e,Macro,1,264,327,2031,63
168,/home/yww/CAS^3/new_data_full_reduce/168/e,Macro,1,528,638,2031,110
168,/home/yww/CAS^3/new_data_full_reduce/168/j,Macro,1,49,97,1999,48
168,/home/yww/CAS^3/new_data_full_reduce/168/j,Macro,1,141,187,1999,46
168,/home/yww/CAS^3/new_data_full_reduce/168/j,Macro,1,539,590,1999,51
168,/home/yww/CAS^3/new_data_full_reduce/168/j,Macro,1,1937,1969,1999,32
169,/home/yww/CAS^3/new_data_full_reduce/169/a,Macro,1,82,173,1019,91
169,/home/yww/CAS^3/new_data_full_reduce/169/a,Macro,1,269,316,1019,47
169,/home/yww/CAS^3/new_data_full_reduce/169/a,Macro,1,342,369,1019,27
169,/home/yww/CAS^3/new_data_full_reduce/169/a,Macro,1,797,827,1019,30
169,/home/yww/CAS^3/new_data_full_reduce/169/a,Macro,1,881,982,1019,101
169,/home/yww/CAS^3/new_data_full_reduce/169/b,Macro,1,1,90,1267,89
169,/home/yww/CAS^3/new_data_full_reduce/169/b,Macro,1,707,781,1267,74
169,/home/yww/CAS^3/new_data_full_reduce/169/c,Macro,1,417,480,3470,63
169,/home/yww/CAS^3/new_data_full_reduce/169/c,Macro,1,722,792,3470,70
169,/home/yww/CAS^3/new_data_full_reduce/169/c,Macro,1,1016,1084,3470,68
169,/home/yww/CAS^3/new_data_full_reduce/169/c,Macro,1,1206,1234,3470,28
169,/home/yww/CAS^3/new_data_full_reduce/169/c,Macro,1,1917,1969,3470,52
169,/home/yww/CAS^3/new_data_full_reduce/169/d,Macro,1,1198,1263,4818,65
169,/home/yww/CAS^3/new_data_full_reduce/169/d,Macro,1,1541,1654,4818,113
169,/home/yww/CAS^3/new_data_full_reduce/169/d,Macro,1,2781,2826,4818,45
169,/home/yww/CAS^3/new_data_full_reduce/169/d,Macro,1,4185,4227,4818,42
169,/home/yww/CAS^3/new_data_full_reduce/169/e,Macro,1,70,101,3081,31
169,/home/yww/CAS^3/new_data_full_reduce/169/e,Macro,1,129,193,3081,64
169,/home/yww/CAS^3/new_data_full_reduce/169/e,Macro,1,446,521,3081,75
169,/home/yww/CAS^3/new_data_full_reduce/169/e,Macro,1,581,681,3081,100
169,/home/yww/CAS^3/new_data_full_reduce/169/e,Macro,1,678,747,3081,69
169,/home/yww/CAS^3/new_data_full_reduce/169/e,Macro,1,857,876,3081,19
169,/home/yww/CAS^3/new_data_full_reduce/169/e,Macro,1,1206,1235,3081,29
169,/home/yww/CAS^3/new_data_full_reduce/169/e,Macro,1,1613,1655,3081,42
169,/home/yww/CAS^3/new_data_full_reduce/169/e,Macro,1,1853,1880,3081,27
169,/home/yww/CAS^3/new_data_full_reduce/169/e,Macro,1,2331,2362,3081,31
169,/home/yww/CAS^3/new_data_full_reduce/169/e,Macro,1,2878,2913,3081,35
169,/home/yww/CAS^3/new_data_full_reduce/169/f,Macro,1,706,800,2309,94
169,/home/yww/CAS^3/new_data_full_reduce/169/f,Macro,1,1011,1061,2309,50
169,/home/yww/CAS^3/new_data_full_reduce/169/f,Macro,1,1329,1366,2309,37
169,/home/yww/CAS^3/new_data_full_reduce/169/g,Macro,1,294,389,2740,95
169,/home/yww/CAS^3/new_data_full_reduce/169/g,Macro,1,723,828,2740,105
169,/home/yww/CAS^3/new_data_full_reduce/169/g,Macro,1,865,962,2740,97
169,/home/yww/CAS^3/new_data_full_reduce/169/g,Macro,1,1074,1144,2740,70
169,/home/yww/CAS^3/new_data_full_reduce/169/g,Macro,1,1433,1501,2740,68
169,/home/yww/CAS^3/new_data_full_reduce/169/g,Macro,1,1772,1859,2740,87
169,/home/yww/CAS^3/new_data_full_reduce/169/g,Macro,1,2020,2054,2740,34
169,/home/yww/CAS^3/new_data_full_reduce/169/g,Macro,1,2174,2231,2740,57
169,/home/yww/CAS^3/new_data_full_reduce/169/g,Macro,1,2368,2415,2740,47
169,/home/yww/CAS^3/new_data_full_reduce/169/h,Macro,1,679,780,3507,101
169,/home/yww/CAS^3/new_data_full_reduce/169/h,Macro,1,728,793,3507,65
169,/home/yww/CAS^3/new_data_full_reduce/169/h,Macro,1,834,858,3507,24
169,/home/yww/CAS^3/new_data_full_reduce/169/h,Macro,1,1377,1413,3507,36
169,/home/yww/CAS^3/new_data_full_reduce/169/h,Macro,1,1737,1780,3507,43
169,/home/yww/CAS^3/new_data_full_reduce/169/h,Macro,1,2948,2973,3507,25
169,/home/yww/CAS^3/new_data_full_reduce/169/i,Macro,1,9,49,4334,40
169,/home/yww/CAS^3/new_data_full_reduce/169/i,Macro,1,68,126,4334,58
169,/home/yww/CAS^3/new_data_full_reduce/169/i,Macro,1,650,759,4334,109
169,/home/yww/CAS^3/new_data_full_reduce/169/i,Macro,1,908,933,4334,25
169,/home/yww/CAS^3/new_data_full_reduce/169/i,Macro,1,972,1006,4334,34
169,/home/yww/CAS^3/new_data_full_reduce/169/i,Macro,1,3840,3866,4334,26
169,/home/yww/CAS^3/new_data_full_reduce/169/i,Micro,2,373,382,4334,9
169,/home/yww/CAS^3/new_data_full_reduce/169/j,Macro,1,559,632,1997,73
169,/home/yww/CAS^3/new_data_full_reduce/169/j,Macro,1,674,709,1997,35
169,/home/yww/CAS^3/new_data_full_reduce/169/j,Macro,1,1021,1139,1997,118
169,/home/yww/CAS^3/new_data_full_reduce/169/k,Macro,1,169,257,2773,88
169,/home/yww/CAS^3/new_data_full_reduce/169/k,Macro,1,410,451,2773,41
169,/home/yww/CAS^3/new_data_full_reduce/169/k,Macro,1,664,698,2773,34
169,/home/yww/CAS^3/new_data_full_reduce/169/k,Macro,1,1952,1991,2773,39
169,/home/yww/CAS^3/new_data_full_reduce/169/l,Macro,1,1,84,4188,83
169,/home/yww/CAS^3/new_data_full_reduce/169/l,Macro,1,143,202,4188,59
169,/home/yww/CAS^3/new_data_full_reduce/169/l,Macro,1,364,407,4188,43
169,/home/yww/CAS^3/new_data_full_reduce/169/l,Macro,1,756,865,4188,109
169,/home/yww/CAS^3/new_data_full_reduce/169/l,Macro,1,1645,1740,4188,95
169,/home/yww/CAS^3/new_data_full_reduce/169/l,Macro,1,2212,2322,4188,110
169,/home/yww/CAS^3/new_data_full_reduce/169/l,Macro,1,2514,2555,4188,41
169,/home/yww/CAS^3/new_data_full_reduce/169/l,Macro,1,3234,3274,4188,40
169,/home/yww/CAS^3/new_data_full_reduce/169/l,Macro,1,3312,3419,4188,107
169,/home/yww/CAS^3/new_data_full_reduce/169/m,Macro,1,1,66,2889,65
169,/home/yww/CAS^3/new_data_full_reduce/169/m,Macro,1,168,230,2889,62
169,/home/yww/CAS^3/new_data_full_reduce/169/m,Macro,1,1210,1276,2889,66
169,/home/yww/CAS^3/new_data_full_reduce/169/m,Macro,1,1794,1876,2889,82
169,/home/yww/CAS^3/new_data_full_reduce/169/m,Macro,1,1887,1942,2889,55
170,/home/yww/CAS^3/new_data_full_reduce/170/b,Macro,1,79,148,1265,69
170,/home/yww/CAS^3/new_data_full_reduce/170/d,Macro,1,1110,1150,4818,40
170,/home/yww/CAS^3/new_data_full_reduce/170/d,Macro,1,2044,2063,4818,19
170,/home/yww/CAS^3/new_data_full_reduce/170/d,Macro,1,2562,2605,4818,43
170,/home/yww/CAS^3/new_data_full_reduce/170/d,Macro,1,3861,3908,4818,47
170,/home/yww/CAS^3/new_data_full_reduce/170/d,Macro,1,4373,4444,4818,71
170,/home/yww/CAS^3/new_data_full_reduce/170/e,Macro,1,25,90,3083,65
170,/home/yww/CAS^3/new_data_full_reduce/170/e,Macro,1,1035,1089,3083,54
170,/home/yww/CAS^3/new_data_full_reduce/170/e,Macro,1,1319,1376,3083,57
170,/home/yww/CAS^3/new_data_full_reduce/170/e,Macro,1,2397,2457,3083,60
170,/home/yww/CAS^3/new_data_full_reduce/170/f,Macro,1,139,218,2309,79
170,/home/yww/CAS^3/new_data_full_reduce/170/g,Macro,1,211,258,2735,47
170,/home/yww/CAS^3/new_data_full_reduce/170/g,Macro,1,381,455,2735,74
170,/home/yww/CAS^3/new_data_full_reduce/170/g,Macro,1,1035,1096,2735,61
170,/home/yww/CAS^3/new_data_full_reduce/170/h,Macro,1,725,792,3508,67
170,/home/yww/CAS^3/new_data_full_reduce/170/i,Macro,1,195,275,4337,80
170,/home/yww/CAS^3/new_data_full_reduce/170/i,Macro,1,275,352,4337,77
170,/home/yww/CAS^3/new_data_full_reduce/170/j,Macro,1,197,250,1999,53
170,/home/yww/CAS^3/new_data_full_reduce/170/j,Macro,1,760,814,1999,54
170,/home/yww/CAS^3/new_data_full_reduce/170/l,Macro,1,1,34,4190,33
170,/home/yww/CAS^3/new_data_full_reduce/170/l,Macro,1,77,164,4190,87
170,/home/yww/CAS^3/new_data_full_reduce/170/l,Macro,1,598,660,4190,62
170,/home/yww/CAS^3/new_data_full_reduce/170/l,Macro,1,3370,3435,4190,65
170,/home/yww/CAS^3/new_data_full_reduce/170/m,Macro,1,106,184,2890,78
170,/home/yww/CAS^3/new_data_full_reduce/170/m,Macro,1,1455,1513,2890,58
170,/home/yww/CAS^3/new_data_full_reduce/170/m,Macro,1,1794,1839,2890,45
170,/home/yww/CAS^3/new_data_full_reduce/170/m,Macro,1,2672,2768,2890,96
171,/home/yww/CAS^3/new_data_full_reduce/171/a,Macro,1,312,338,1018,26
171,/home/yww/CAS^3/new_data_full_reduce/171/a,Macro,1,976,1017,1018,41
171,/home/yww/CAS^3/new_data_full_reduce/171/a,Micro,2,222,230,1018,8
171,/home/yww/CAS^3/new_data_full_reduce/171/b,Macro,1,56,124,1267,68
171,/home/yww/CAS^3/new_data_full_reduce/171/b,Macro,1,912,985,1267,73
171,/home/yww/CAS^3/new_data_full_reduce/171/c,Macro,1,433,470,1820,37
171,/home/yww/CAS^3/new_data_full_reduce/171/d,Micro,2,42,57,4818,15
171,/home/yww/CAS^3/new_data_full_reduce/171/d,Micro,2,536,546,4818,10
171,/home/yww/CAS^3/new_data_full_reduce/171/d,Micro,2,2157,2172,4818,15
171,/home/yww/CAS^3/new_data_full_reduce/171/e,Macro,1,960,1025,2662,65
171,/home/yww/CAS^3/new_data_full_reduce/171/e,Macro,1,1465,1484,2662,19
171,/home/yww/CAS^3/new_data_full_reduce/171/e,Macro,1,1682,1751,2662,69
171,/home/yww/CAS^3/new_data_full_reduce/171/e,Macro,1,2141,2171,2662,30
171,/home/yww/CAS^3/new_data_full_reduce/171/g,Macro,1,184,261,2741,77
171,/home/yww/CAS^3/new_data_full_reduce/171/g,Macro,1,508,530,2741,22
171,/home/yww/CAS^3/new_data_full_reduce/171/g,Macro,1,1054,1112,2741,58
171,/home/yww/CAS^3/new_data_full_reduce/171/g,Micro,2,92,99,2741,7
171,/home/yww/CAS^3/new_data_full_reduce/171/g,Micro,2,1878,1888,2741,10
171,/home/yww/CAS^3/new_data_full_reduce/171/h,Micro,2,156,166,2288,10
171,/home/yww/CAS^3/new_data_full_reduce/171/i,Macro,1,2436,2491,2506,55
171,/home/yww/CAS^3/new_data_full_reduce/171/k,Macro,1,83,117,2771,34
171,/home/yww/CAS^3/new_data_full_reduce/171/k,Macro,1,125,163,2771,38
171,/home/yww/CAS^3/new_data_full_reduce/171/k,Macro,1,1292,1374,2771,82
171,/home/yww/CAS^3/new_data_full_reduce/171/k,Macro,1,1919,1966,2771,47
171,/home/yww/CAS^3/new_data_full_reduce/171/l,Macro,1,127,176,2221,49
171,/home/yww/CAS^3/new_data_full_reduce/171/l,Macro,1,755,836,2221,81
171,/home/yww/CAS^3/new_data_full_reduce/171/l,Micro,2,1415,1428,2221,13
171,/home/yww/CAS^3/new_data_full_reduce/171/l,Micro,2,1747,1758,2221,11
171,/home/yww/CAS^3/new_data_full_reduce/171/m,Macro,1,94,193,2888,99
171,/home/yww/CAS^3/new_data_full_reduce/171/m,Macro,1,1051,1113,2888,62
171,/home/yww/CAS^3/new_data_full_reduce/171/m,Macro,1,2378,2440,2888,62
172,/home/yww/CAS^3/new_data_full_reduce/172/e,Macro,1,112,178,2707,66
172,/home/yww/CAS^3/new_data_full_reduce/172/e,Macro,1,323,372,2707,49
172,/home/yww/CAS^3/new_data_full_reduce/172/g,Macro,1,653,699,2616,46
172,/home/yww/CAS^3/new_data_full_reduce/172/g,Macro,1,2089,2131,2616,42
172,/home/yww/CAS^3/new_data_full_reduce/172/h,Macro,1,1165,1204,3504,39
172,/home/yww/CAS^3/new_data_full_reduce/172/h,Macro,1,1211,1273,3504,62
172,/home/yww/CAS^3/new_data_full_reduce/172/h,Macro,1,1514,1537,3504,23
172,/home/yww/CAS^3/new_data_full_reduce/172/h,Macro,1,1611,1642,3504,31
172,/home/yww/CAS^3/new_data_full_reduce/172/h,Micro,2,200,213,3504,13
172,/home/yww/CAS^3/new_data_full_reduce/172/i,Macro,1,78,134,3736,56
172,/home/yww/CAS^3/new_data_full_reduce/172/k,Micro,2,1848,1862,2462,14
172,/home/yww/CAS^3/new_data_full_reduce/172/l,Macro,1,28,73,4191,45
172,/home/yww/CAS^3/new_data_full_reduce/172/l,Macro,1,1023,1083,4191,60
172,/home/yww/CAS^3/new_data_full_reduce/172/l,Macro,1,2176,2215,4191,39
172,/home/yww/CAS^3/new_data_full_reduce/172/l,Macro,1,2305,2408,4191,103
172,/home/yww/CAS^3/new_data_full_reduce/172/l,Micro,2,1613,1627,4191,14
172,/home/yww/CAS^3/new_data_full_reduce/172/m,Macro,1,866,957,2889,91
172,/home/yww/CAS^3/new_data_full_reduce/172/m,Macro,1,1301,1414,2889,113
172,/home/yww/CAS^3/new_data_full_reduce/172/m,Macro,1,2803,2887,2889,84
173,/home/yww/CAS^3/new_data_full_reduce/173/c,Macro,1,887,921,3380,34
174,/home/yww/CAS^3/new_data_full_reduce/174/a,Macro,1,1,38,376,37
174,/home/yww/CAS^3/new_data_full_reduce/174/c,Macro,1,249,287,3468,38
174,/home/yww/CAS^3/new_data_full_reduce/174/c,Macro,1,2379,2464,3468,85
174,/home/yww/CAS^3/new_data_full_reduce/174/c,Macro,1,2539,2599,3468,60
174,/home/yww/CAS^3/new_data_full_reduce/174/c,Macro,1,2793,2864,3468,71
174,/home/yww/CAS^3/new_data_full_reduce/174/c,Macro,1,2932,3004,3468,72
174,/home/yww/CAS^3/new_data_full_reduce/174/e,Macro,1,1136,1169,3014,33
174,/home/yww/CAS^3/new_data_full_reduce/174/e,Macro,1,1369,1422,3014,53
174,/home/yww/CAS^3/new_data_full_reduce/174/e,Macro,1,2671,2726,3014,55
174,/home/yww/CAS^3/new_data_full_reduce/174/e,Macro,1,2816,2923,3014,107
174,/home/yww/CAS^3/new_data_full_reduce/174/f,Macro,1,156,197,1869,41
174,/home/yww/CAS^3/new_data_full_reduce/174/f,Macro,1,249,288,1869,39
174,/home/yww/CAS^3/new_data_full_reduce/174/i,Macro,1,620,674,2411,54
174,/home/yww/CAS^3/new_data_full_reduce/174/j,Macro,1,811,869,1999,58
174,/home/yww/CAS^3/new_data_full_reduce/174/l,Macro,1,1545,1642,4047,97
174,/home/yww/CAS^3/new_data_full_reduce/174/l,Macro,1,2686,2799,4047,113
174,/home/yww/CAS^3/new_data_full_reduce/174/l,Macro,1,3019,3117,4047,98
175,/home/yww/CAS^3/new_data_full_reduce/175/a,Macro,1,36,110,1018,74
175,/home/yww/CAS^3/new_data_full_reduce/175/a,Macro,1,222,342,1018,120
175,/home/yww/CAS^3/new_data_full_reduce/175/a,Macro,1,538,582,1018,44
175,/home/yww/CAS^3/new_data_full_reduce/175/b,Macro,1,409,516,1267,107
175,/home/yww/CAS^3/new_data_full_reduce/175/b,Micro,2,56,64,1267,8
175,/home/yww/CAS^3/new_data_full_reduce/175/c,Macro,1,21,42,3470,21
175,/home/yww/CAS^3/new_data_full_reduce/175/c,Macro,1,42,121,3470,79
175,/home/yww/CAS^3/new_data_full_reduce/175/e,Macro,1,85,119,3082,34
175,/home/yww/CAS^3/new_data_full_reduce/175/f,Macro,1,561,603,2310,42
175,/home/yww/CAS^3/new_data_full_reduce/175/f,Macro,1,1030,1083,2310,53
175,/home/yww/CAS^3/new_data_full_reduce/175/f,Macro,1,1797,1913,2310,116
175,/home/yww/CAS^3/new_data_full_reduce/175/j,Macro,1,169,222,1998,53
175,/home/yww/CAS^3/new_data_full_reduce/175/j,Macro,1,398,503,1998,105
175,/home/yww/CAS^3/new_data_full_reduce/175/k,Macro,1,1900,1954,2775,54
175,/home/yww/CAS^3/new_data_full_reduce/175/l,Macro,1,1,82,4191,81
175,/home/yww/CAS^3/new_data_full_reduce/175/m,Macro,1,1,40,2889,39
176,/home/yww/CAS^3/new_data_full_reduce/176/a,Macro,1,35,102,1021,67
176,/home/yww/CAS^3/new_data_full_reduce/176/a,Macro,1,363,469,1021,106
176,/home/yww/CAS^3/new_data_full_reduce/176/b,Macro,1,144,222,1267,78
176,/home/yww/CAS^3/new_data_full_reduce/176/b,Macro,1,906,986,1267,80
176,/home/yww/CAS^3/new_data_full_reduce/176/c,Macro,1,1502,1567,3471,65
176,/home/yww/CAS^3/new_data_full_reduce/176/c,Macro,1,2318,2364,3471,46
176,/home/yww/CAS^3/new_data_full_reduce/176/c,Macro,1,3381,3468,3471,87
176,/home/yww/CAS^3/new_data_full_reduce/176/e,Macro,1,1295,1336,3081,41
176,/home/yww/CAS^3/new_data_full_reduce/176/e,Macro,1,2506,2570,3081,64
176,/home/yww/CAS^3/new_data_full_reduce/176/f,Macro,1,1291,1340,2309,49
176,/home/yww/CAS^3/new_data_full_reduce/176/g,Macro,1,600,650,2739,50
176,/home/yww/CAS^3/new_data_full_reduce/176/g,Macro,1,2359,2403,2739,44
176,/home/yww/CAS^3/new_data_full_reduce/176/g,Macro,1,2519,2568,2739,49
176,/home/yww/CAS^3/new_data_full_reduce/176/h,Macro,1,1,35,3506,34
176,/home/yww/CAS^3/new_data_full_reduce/176/h,Macro,1,1665,1725,3506,60
176,/home/yww/CAS^3/new_data_full_reduce/176/h,Macro,1,2765,2820,3506,55
176,/home/yww/CAS^3/new_data_full_reduce/176/i,Macro,1,552,638,4334,86
176,/home/yww/CAS^3/new_data_full_reduce/176/i,Macro,1,1203,1302,4334,99
176,/home/yww/CAS^3/new_data_full_reduce/176/i,Macro,1,2732,2800,4334,68
176,/home/yww/CAS^3/new_data_full_reduce/176/i,Macro,1,3630,3717,4334,87
176,/home/yww/CAS^3/new_data_full_reduce/176/l,Macro,1,112,184,4189,72
176,/home/yww/CAS^3/new_data_full_reduce/176/l,Macro,1,1079,1168,4189,89
176,/home/yww/CAS^3/new_data_full_reduce/176/l,Macro,1,1369,1434,4189,65
176,/home/yww/CAS^3/new_data_full_reduce/176/l,Macro,1,2887,2942,4189,55
176,/home/yww/CAS^3/new_data_full_reduce/176/l,Macro,1,3345,3408,4189,63
176,/home/yww/CAS^3/new_data_full_reduce/176/l,Macro,1,3681,3738,4189,57
177,/home/yww/CAS^3/new_data_full_reduce/177/a,Macro,1,397,467,1021,70
177,/home/yww/CAS^3/new_data_full_reduce/177/b,Macro,1,1031,1092,1266,61
177,/home/yww/CAS^3/new_data_full_reduce/177/c,Macro,1,1185,1209,3472,24
177,/home/yww/CAS^3/new_data_full_reduce/177/c,Macro,1,2902,2951,3472,49
177,/home/yww/CAS^3/new_data_full_reduce/177/d,Macro,1,2012,2058,4817,46
177,/home/yww/CAS^3/new_data_full_reduce/177/d,Micro,2,4164,4177,4817,13
177,/home/yww/CAS^3/new_data_full_reduce/177/e,Macro,1,428,499,3084,71
177,/home/yww/CAS^3/new_data_full_reduce/177/e,Macro,1,885,923,3084,38
177,/home/yww/CAS^3/new_data_full_reduce/177/e,Macro,1,2877,2922,3084,45
177,/home/yww/CAS^3/new_data_full_reduce/177/g,Macro,1,1500,1613,2741,113
177,/home/yww/CAS^3/new_data_full_reduce/177/i,Macro,1,1264,1331,4337,67
177,/home/yww/CAS^3/new_data_full_reduce/177/i,Macro,1,2553,2635,4337,82
177,/home/yww/CAS^3/new_data_full_reduce/177/j,Macro,1,30,110,1998,80
177,/home/yww/CAS^3/new_data_full_reduce/177/j,Macro,1,1100,1165,1998,65
177,/home/yww/CAS^3/new_data_full_reduce/177/k,Macro,1,9,87,2775,78
177,/home/yww/CAS^3/new_data_full_reduce/177/l,Macro,1,655,709,4189,54
177,/home/yww/CAS^3/new_data_full_reduce/177/l,Macro,1,1131,1194,4189,63
177,/home/yww/CAS^3/new_data_full_reduce/177/l,Macro,1,1194,1279,4189,85
177,/home/yww/CAS^3/new_data_full_reduce/177/l,Macro,1,2588,2663,4189,75
177,/home/yww/CAS^3/new_data_full_reduce/177/l,Macro,1,2672,2734,4189,62
177,/home/yww/CAS^3/new_data_full_reduce/177/l,Macro,1,3488,3572,4189,84
177,/home/yww/CAS^3/new_data_full_reduce/177/m,Macro,1,646,670,2890,24
178,/home/yww/CAS^3/new_data_full_reduce/178/c,Macro,1,904,920,3469,16
178,/home/yww/CAS^3/new_data_full_reduce/178/c,Macro,1,924,952,3469,28
178,/home/yww/CAS^3/new_data_full_reduce/178/j,Macro,1,736,759,1999,23
178,/home/yww/CAS^3/new_data_full_reduce/178/j,Macro,1,759,784,1999,25
178,/home/yww/CAS^3/new_data_full_reduce/178/j,Macro,1,815,860,1999,45
178,/home/yww/CAS^3/new_data_full_reduce/178/j,Macro,1,951,987,1999,36
178,/home/yww/CAS^3/new_data_full_reduce/178/j,Macro,1,987,1044,1999,57
178,/home/yww/CAS^3/new_data_full_reduce/178/j,Micro,2,1180,1188,1999,8
178,/home/yww/CAS^3/new_data_full_reduce/178/k,Macro,1,1527,1554,2773,27
178,/home/yww/CAS^3/new_data_full_reduce/178/k,Macro,1,2327,2360,2773,33
178,/home/yww/CAS^3/new_data_full_reduce/178/m,Micro,2,27,42,2889,15
179,/home/yww/CAS^3/new_data_full_reduce/179/e,Macro,1,1,50,3083,49
179,/home/yww/CAS^3/new_data_full_reduce/179/e,Macro,1,179,262,3083,83
179,/home/yww/CAS^3/new_data_full_reduce/179/e,Macro,1,450,568,3083,118
179,/home/yww/CAS^3/new_data_full_reduce/179/e,Macro,1,772,848,3083,76
179,/home/yww/CAS^3/new_data_full_reduce/179/e,Macro,1,2102,2159,3083,57
179,/home/yww/CAS^3/new_data_full_reduce/179/e,Macro,1,2695,2730,3083,35
179,/home/yww/CAS^3/new_data_full_reduce/179/f,Macro,1,678,736,2307,58
179,/home/yww/CAS^3/new_data_full_reduce/179/f,Macro,1,1385,1461,2307,76
179,/home/yww/CAS^3/new_data_full_reduce/179/g,Macro,1,24,88,2739,64
179,/home/yww/CAS^3/new_data_full_reduce/179/g,Macro,1,305,363,2739,58
179,/home/yww/CAS^3/new_data_full_reduce/179/g,Macro,1,363,412,2739,49
179,/home/yww/CAS^3/new_data_full_reduce/179/g,Macro,1,522,585,2739,63
179,/home/yww/CAS^3/new_data_full_reduce/179/g,Macro,1,585,697,2739,112
179,/home/yww/CAS^3/new_data_full_reduce/179/g,Macro,1,1032,1066,2739,34
179,/home/yww/CAS^3/new_data_full_reduce/179/g,Macro,1,2191,2248,2739,57
179,/home/yww/CAS^3/new_data_full_reduce/179/h,Macro,1,383,434,3504,51
179,/home/yww/CAS^3/new_data_full_reduce/179/i,Macro,1,97,128,4338,31
179,/home/yww/CAS^3/new_data_full_reduce/179/i,Macro,1,602,713,4338,111
179,/home/yww/CAS^3/new_data_full_reduce/179/i,Macro,1,1024,1102,4338,78
179,/home/yww/CAS^3/new_data_full_reduce/179/i,Macro,1,1120,1166,4338,46
179,/home/yww/CAS^3/new_data_full_reduce/179/i,Macro,1,3163,3209,4338,46
179,/home/yww/CAS^3/new_data_full_reduce/179/i,Macro,1,3211,3242,4338,31
179,/home/yww/CAS^3/new_data_full_reduce/179/i,Macro,1,3368,3411,4338,43
179,/home/yww/CAS^3/new_data_full_reduce/179/j,Macro,1,1018,1038,2000,20
179,/home/yww/CAS^3/new_data_full_reduce/179/j,Macro,1,1038,1057,2000,19
179,/home/yww/CAS^3/new_data_full_reduce/179/j,Macro,1,1369,1426,2000,57
179,/home/yww/CAS^3/new_data_full_reduce/179/k,Macro,1,1134,1179,2773,45
179,/home/yww/CAS^3/new_data_full_reduce/179/l,Macro,1,23,55,4188,32
179,/home/yww/CAS^3/new_data_full_reduce/179/l,Macro,1,473,586,4188,113
179,/home/yww/CAS^3/new_data_full_reduce/179/l,Macro,1,936,1018,4188,82
179,/home/yww/CAS^3/new_data_full_reduce/179/l,Macro,1,4099,4185,4188,86
179,/home/yww/CAS^3/new_data_full_reduce/179/m,Macro,1,456,548,2888,92
179,/home/yww/CAS^3/new_data_full_reduce/179/m,Macro,1,896,963,2888,67
179,/home/yww/CAS^3/new_data_full_reduce/179/m,Macro,1,1210,1259,2888,49
180,/home/yww/CAS^3/new_data_full_reduce/180/b,Macro,1,1,54,1265,53
180,/home/yww/CAS^3/new_data_full_reduce/180/f,Macro,1,1,84,2308,83
180,/home/yww/CAS^3/new_data_full_reduce/180/g,Macro,1,899,953,2740,54
180,/home/yww/CAS^3/new_data_full_reduce/180/g,Macro,1,966,1034,2740,68
180,/home/yww/CAS^3/new_data_full_reduce/180/i,Macro,1,216,262,4337,46
180,/home/yww/CAS^3/new_data_full_reduce/180/i,Macro,1,1963,2014,4337,51
180,/home/yww/CAS^3/new_data_full_reduce/180/i,Macro,1,2310,2364,4337,54
180,/home/yww/CAS^3/new_data_full_reduce/180/i,Macro,1,2896,2985,4337,89
180,/home/yww/CAS^3/new_data_full_reduce/180/i,Macro,1,3238,3270,4337,32
180,/home/yww/CAS^3/new_data_full_reduce/180/j,Macro,1,1,98,1998,97
180,/home/yww/CAS^3/new_data_full_reduce/180/j,Macro,1,728,781,1998,53
180,/home/yww/CAS^3/new_data_full_reduce/180/j,Macro,1,1714,1754,1998,40
180,/home/yww/CAS^3/new_data_full_reduce/180/k,Macro,1,110,196,2774,86
180,/home/yww/CAS^3/new_data_full_reduce/180/l,Macro,1,49,133,4190,84
180,/home/yww/CAS^3/new_data_full_reduce/180/l,Macro,1,820,879,4190,59
180,/home/yww/CAS^3/new_data_full_reduce/180/l,Macro,1,1465,1528,4190,63
180,/home/yww/CAS^3/new_data_full_reduce/180/l,Macro,1,1616,1723,4190,107
180,/home/yww/CAS^3/new_data_full_reduce/180/l,Macro,1,3730,3813,4190,83
180,/home/yww/CAS^3/new_data_full_reduce/180/m,Macro,1,1,77,2888,76
180,/home/yww/CAS^3/new_data_full_reduce/180/m,Macro,1,268,291,2888,23
181,/home/yww/CAS^3/new_data_full_reduce/181/a,Macro,1,35,122,1020,87
181,/home/yww/CAS^3/new_data_full_reduce/181/b,Macro,1,73,125,1267,52
181,/home/yww/CAS^3/new_data_full_reduce/181/b,Macro,1,261,330,1267,69
181,/home/yww/CAS^3/new_data_full_reduce/181/b,Macro,1,441,485,1267,44
181,/home/yww/CAS^3/new_data_full_reduce/181/b,Macro,1,811,873,1267,62
181,/home/yww/CAS^3/new_data_full_reduce/181/c,Macro,1,1502,1602,3470,100
181,/home/yww/CAS^3/new_data_full_reduce/181/c,Macro,1,1617,1657,3470,40
181,/home/yww/CAS^3/new_data_full_reduce/181/c,Macro,1,1676,1700,3470,24
181,/home/yww/CAS^3/new_data_full_reduce/181/c,Macro,1,2309,2421,3470,112
181,/home/yww/CAS^3/new_data_full_reduce/181/c,Micro,2,1460,1469,3470,9
181,/home/yww/CAS^3/new_data_full_reduce/181/d,Macro,1,2514,2591,4818,77
181,/home/yww/CAS^3/new_data_full_reduce/181/d,Macro,1,3194,3276,4818,82
181,/home/yww/CAS^3/new_data_full_reduce/181/d,Macro,1,3579,3635,4818,56
181,/home/yww/CAS^3/new_data_full_reduce/181/d,Micro,2,16,30,4818,14
181,/home/yww/CAS^3/new_data_full_reduce/181/d,Micro,2,2370,2384,4818,14
181,/home/yww/CAS^3/new_data_full_reduce/181/d,Micro,2,3284,3298,4818,14
181,/home/yww/CAS^3/new_data_full_reduce/181/e,Macro,1,176,206,3082,30
181,/home/yww/CAS^3/new_data_full_reduce/181/e,Macro,1,2777,2814,3082,37
181,/home/yww/CAS^3/new_data_full_reduce/181/g,Macro,1,26,68,2741,42
181,/home/yww/CAS^3/new_data_full_reduce/181/g,Macro,1,1084,1127,2741,43
181,/home/yww/CAS^3/new_data_full_reduce/181/h,Macro,1,1717,1777,3504,60
181,/home/yww/CAS^3/new_data_full_reduce/181/h,Macro,1,1821,1881,3504,60
181,/home/yww/CAS^3/new_data_full_reduce/181/i,Macro,1,39,101,4337,62
181,/home/yww/CAS^3/new_data_full_reduce/181/i,Macro,1,132,198,4337,66
181,/home/yww/CAS^3/new_data_full_reduce/181/i,Macro,1,1146,1185,4337,39
181,/home/yww/CAS^3/new_data_full_reduce/181/i,Macro,1,1415,1483,4337,68
181,/home/yww/CAS^3/new_data_full_reduce/181/i,Macro,1,1725,1775,4337,50
181,/home/yww/CAS^3/new_data_full_reduce/181/i,Macro,1,4226,4336,4337,110
181,/home/yww/CAS^3/new_data_full_reduce/181/j,Macro,1,626,671,1999,45
181,/home/yww/CAS^3/new_data_full_reduce/181/j,Macro,1,752,798,1999,46
181,/home/yww/CAS^3/new_data_full_reduce/181/k,Macro,1,990,1073,2772,83
181,/home/yww/CAS^3/new_data_full_reduce/181/k,Macro,1,1125,1188,2772,63
181,/home/yww/CAS^3/new_data_full_reduce/181/l,Macro,1,618,679,4189,61
181,/home/yww/CAS^3/new_data_full_reduce/181/l,Macro,1,3680,3743,4189,63
181,/home/yww/CAS^3/new_data_full_reduce/181/l,Micro,2,1308,1319,4189,11
181,/home/yww/CAS^3/new_data_full_reduce/181/m,Macro,1,2214,2250,2890,36
181,/home/yww/CAS^3/new_data_full_reduce/181/m,Micro,2,30,42,2890,12
182,/home/yww/CAS^3/new_data_full_reduce/182/c,Macro,1,12,45,3469,33
182,/home/yww/CAS^3/new_data_full_reduce/182/c,Macro,1,117,149,3469,32
182,/home/yww/CAS^3/new_data_full_reduce/182/d,Macro,1,290,338,4817,48
182,/home/yww/CAS^3/new_data_full_reduce/182/e,Macro,1,7,92,3081,85
182,/home/yww/CAS^3/new_data_full_reduce/182/e,Macro,1,149,179,3081,30
182,/home/yww/CAS^3/new_data_full_reduce/182/f,Macro,1,14,40,2306,26
182,/home/yww/CAS^3/new_data_full_reduce/182/f,Macro,1,527,564,2306,37
182,/home/yww/CAS^3/new_data_full_reduce/182/g,Macro,1,2628,2735,2739,107
182,/home/yww/CAS^3/new_data_full_reduce/182/h,Macro,1,1646,1694,3506,48
182,/home/yww/CAS^3/new_data_full_reduce/182/i,Macro,1,770,832,4333,62
182,/home/yww/CAS^3/new_data_full_reduce/182/i,Macro,1,920,1036,4333,116
182,/home/yww/CAS^3/new_data_full_reduce/182/i,Macro,1,1001,1036,4333,35
182,/home/yww/CAS^3/new_data_full_reduce/182/i,Macro,1,1139,1229,4333,90
182,/home/yww/CAS^3/new_data_full_reduce/182/i,Macro,1,3013,3112,4333,99
182,/home/yww/CAS^3/new_data_full_reduce/182/j,Macro,1,432,503,1999,71
182,/home/yww/CAS^3/new_data_full_reduce/182/j,Macro,1,1241,1311,1999,70
182,/home/yww/CAS^3/new_data_full_reduce/182/j,Macro,1,1882,1986,1999,104
182,/home/yww/CAS^3/new_data_full_reduce/182/k,Macro,1,542,569,2774,27
182,/home/yww/CAS^3/new_data_full_reduce/182/k,Macro,1,2096,2165,2774,69
182,/home/yww/CAS^3/new_data_full_reduce/182/k,Macro,1,2330,2428,2774,98
182,/home/yww/CAS^3/new_data_full_reduce/182/l,Macro,1,1,40,4190,39
182,/home/yww/CAS^3/new_data_full_reduce/182/l,Macro,1,361,421,4190,60
182,/home/yww/CAS^3/new_data_full_reduce/182/l,Macro,1,2113,2189,4190,76
182,/home/yww/CAS^3/new_data_full_reduce/182/l,Macro,1,4048,4140,4190,92
182,/home/yww/CAS^3/new_data_full_reduce/182/m,Macro,1,709,773,2891,64
183,/home/yww/CAS^3/new_data_full_reduce/183/b,Macro,1,1,50,1265,49
183,/home/yww/CAS^3/new_data_full_reduce/183/b,Macro,1,760,809,1265,49
183,/home/yww/CAS^3/new_data_full_reduce/183/c,Macro,1,2741,2783,3470,42
183,/home/yww/CAS^3/new_data_full_reduce/183/c,Macro,1,2831,2894,3470,63
183,/home/yww/CAS^3/new_data_full_reduce/183/c,Macro,1,2962,3028,3470,66
183,/home/yww/CAS^3/new_data_full_reduce/183/i,Macro,1,829,886,4337,57
183,/home/yww/CAS^3/new_data_full_reduce/183/j,Macro,1,437,515,1998,78
183,/home/yww/CAS^3/new_data_full_reduce/183/m,Macro,1,2741,2809,2889,68
183,/home/yww/CAS^3/new_data_full_reduce/183/m,Micro,2,128,143,2889,15
184,/home/yww/CAS^3/new_data_full_reduce/184/a,Macro,1,28,80,1020,52
184,/home/yww/CAS^3/new_data_full_reduce/184/a,Macro,1,738,798,1020,60
184,/home/yww/CAS^3/new_data_full_reduce/184/a,Macro,1,808,869,1020,61
184,/home/yww/CAS^3/new_data_full_reduce/184/a,Macro,1,950,968,1020,18
184,/home/yww/CAS^3/new_data_full_reduce/184/b,Macro,1,20,82,1269,62
184,/home/yww/CAS^3/new_data_full_reduce/184/b,Macro,1,204,286,1269,82
184,/home/yww/CAS^3/new_data_full_reduce/184/b,Macro,1,306,422,1269,116
184,/home/yww/CAS^3/new_data_full_reduce/184/b,Macro,1,353,422,1269,69
184,/home/yww/CAS^3/new_data_full_reduce/184/b,Macro,1,860,881,1269,21
184,/home/yww/CAS^3/new_data_full_reduce/184/c,Macro,1,125,142,3470,17
184,/home/yww/CAS^3/new_data_full_reduce/184/c,Macro,1,217,284,3470,67
184,/home/yww/CAS^3/new_data_full_reduce/184/c,Macro,1,919,963,3470,44
184,/home/yww/CAS^3/new_data_full_reduce/184/c,Macro,1,1010,1036,3470,26
184,/home/yww/CAS^3/new_data_full_reduce/184/c,Macro,1,1263,1284,3470,21
184,/home/yww/CAS^3/new_data_full_reduce/184/c,Macro,1,3368,3460,3470,92
184,/home/yww/CAS^3/new_data_full_reduce/184/d,Macro,1,3788,3817,4818,29
184,/home/yww/CAS^3/new_data_full_reduce/184/d,Macro,1,3862,3909,4818,47
184,/home/yww/CAS^3/new_data_full_reduce/184/e,Macro,1,408,455,3082,47
184,/home/yww/CAS^3/new_data_full_reduce/184/e,Macro,1,862,952,3082,90
184,/home/yww/CAS^3/new_data_full_reduce/184/f,Macro,1,435,484,2311,49
184,/home/yww/CAS^3/new_data_full_reduce/184/f,Macro,1,587,641,2311,54
184,/home/yww/CAS^3/new_data_full_reduce/184/f,Macro,1,1773,1812,2311,39
184,/home/yww/CAS^3/new_data_full_reduce/184/f,Macro,1,2198,2232,2311,34
184,/home/yww/CAS^3/new_data_full_reduce/184/h,Macro,1,1452,1511,3505,59
184,/home/yww/CAS^3/new_data_full_reduce/184/h,Macro,1,1532,1572,3505,40
184,/home/yww/CAS^3/new_data_full_reduce/184/h,Micro,2,1738,1751,3505,13
184,/home/yww/CAS^3/new_data_full_reduce/184/h,Micro,2,3407,3413,3505,6
184,/home/yww/CAS^3/new_data_full_reduce/184/h,Micro,2,3414,3424,3505,10
184,/home/yww/CAS^3/new_data_full_reduce/184/i,Macro,1,2775,2806,4338,31
184,/home/yww/CAS^3/new_data_full_reduce/184/i,Macro,1,3399,3460,4338,61
184,/home/yww/CAS^3/new_data_full_reduce/184/i,Macro,1,3542,3582,4338,40
184,/home/yww/CAS^3/new_data_full_reduce/184/i,Micro,2,1,16,4338,15
184,/home/yww/CAS^3/new_data_full_reduce/184/i,Micro,2,3332,3347,4338,15
184,/home/yww/CAS^3/new_data_full_reduce/184/j,Macro,1,639,675,1998,36
184,/home/yww/CAS^3/new_data_full_reduce/184/j,Macro,1,720,781,1998,61
184,/home/yww/CAS^3/new_data_full_reduce/184/j,Micro,2,223,237,1998,14
184,/home/yww/CAS^3/new_data_full_reduce/184/j,Micro,2,1370,1383,1998,13
184,/home/yww/CAS^3/new_data_full_reduce/184/k,Macro,1,274,308,2774,34
184,/home/yww/CAS^3/new_data_full_reduce/184/k,Macro,1,308,402,2774,94
184,/home/yww/CAS^3/new_data_full_reduce/184/k,Macro,1,472,522,2774,50
184,/home/yww/CAS^3/new_data_full_reduce/184/k,Macro,1,967,1043,2774,76
184,/home/yww/CAS^3/new_data_full_reduce/184/k,Macro,1,2723,2772,2774,49
184,/home/yww/CAS^3/new_data_full_reduce/184/k,Micro,2,145,157,2774,12
184,/home/yww/CAS^3/new_data_full_reduce/184/m,Macro,1,120,139,2888,19
184,/home/yww/CAS^3/new_data_full_reduce/184/m,Macro,1,180,242,2888,62
184,/home/yww/CAS^3/new_data_full_reduce/184/m,Macro,1,517,547,2888,30
184,/home/yww/CAS^3/new_data_full_reduce/184/m,Macro,1,896,918,2888,22
184,/home/yww/CAS^3/new_data_full_reduce/184/m,Macro,1,948,1002,2888,54
185,/home/yww/CAS^3/new_data_full_reduce/185/a,Macro,1,225,284,1021,59
185,/home/yww/CAS^3/new_data_full_reduce/185/a,Macro,1,332,445,1021,113
185,/home/yww/CAS^3/new_data_full_reduce/185/b,Macro,1,411,531,1267,120
185,/home/yww/CAS^3/new_data_full_reduce/185/j,Macro,1,402,429,1999,27
185,/home/yww/CAS^3/new_data_full_reduce/185/j,Macro,1,1127,1187,1999,60
185,/home/yww/CAS^3/new_data_full_reduce/185/l,Macro,1,777,847,3057,70
185,/home/yww/CAS^3/new_data_full_reduce/185/l,Macro,1,1426,1456,3057,30
185,/home/yww/CAS^3/new_data_full_reduce/185/l,Macro,1,2159,2238,3057,79
186,/home/yww/CAS^3/new_data_full_reduce/186/b,Macro,1,196,290,1268,94
186,/home/yww/CAS^3/new_data_full_reduce/186/b,Macro,1,305,419,1268,114
186,/home/yww/CAS^3/new_data_full_reduce/186/b,Macro,1,774,874,1268,100
186,/home/yww/CAS^3/new_data_full_reduce/186/c,Macro,1,471,555,3472,84
186,/home/yww/CAS^3/new_data_full_reduce/186/c,Macro,1,522,583,3472,61
186,/home/yww/CAS^3/new_data_full_reduce/186/c,Macro,1,660,712,3472,52
186,/home/yww/CAS^3/new_data_full_reduce/186/c,Macro,1,829,910,3472,81
186,/home/yww/CAS^3/new_data_full_reduce/186/c,Macro,1,1186,1223,3472,37
186,/home/yww/CAS^3/new_data_full_reduce/186/c,Macro,1,1230,1269,3472,39
186,/home/yww/CAS^3/new_data_full_reduce/186/c,Macro,1,1502,1593,3472,91
186,/home/yww/CAS^3/new_data_full_reduce/186/c,Macro,1,1596,1683,3472,87
186,/home/yww/CAS^3/new_data_full_reduce/186/c,Macro,1,1773,1818,3472,45
186,/home/yww/CAS^3/new_data_full_reduce/186/c,Macro,1,1967,2032,3472,65
186,/home/yww/CAS^3/new_data_full_reduce/186/c,Macro,1,2034,2151,3472,117
186,/home/yww/CAS^3/new_data_full_reduce/186/c,Micro,2,333,348,3472,15
186,/home/yww/CAS^3/new_data_full_reduce/186/e,Macro,1,1,74,3084,73
186,/home/yww/CAS^3/new_data_full_reduce/186/g,Macro,1,767,797,2740,30
186,/home/yww/CAS^3/new_data_full_reduce/186/j,Macro,1,612,699,1998,87
186,/home/yww/CAS^3/new_data_full_reduce/186/j,Macro,1,1183,1254,1998,71
186,/home/yww/CAS^3/new_data_full_reduce/186/l,Macro,1,19,54,4189,35
187,/home/yww/CAS^3/new_data_full_reduce/187/a,Macro,1,190,213,1019,23
187,/home/yww/CAS^3/new_data_full_reduce/187/a,Macro,1,413,439,1019,26
187,/home/yww/CAS^3/new_data_full_reduce/187/b,Macro,1,442,465,1266,23
187,/home/yww/CAS^3/new_data_full_reduce/187/b,Macro,1,478,505,1266,27
187,/home/yww/CAS^3/new_data_full_reduce/187/b,Macro,1,505,576,1266,71
187,/home/yww/CAS^3/new_data_full_reduce/187/b,Macro,1,635,709,1266,74
187,/home/yww/CAS^3/new_data_full_reduce/187/c,Macro,1,1,31,3468,30
187,/home/yww/CAS^3/new_data_full_reduce/187/c,Macro,1,405,425,3468,20
187,/home/yww/CAS^3/new_data_full_reduce/187/c,Macro,1,2591,2618,3468,27
187,/home/yww/CAS^3/new_data_full_reduce/187/d,Macro,1,568,604,4817,36
187,/home/yww/CAS^3/new_data_full_reduce/187/d,Macro,1,1349,1396,4817,47
187,/home/yww/CAS^3/new_data_full_reduce/187/d,Macro,1,1957,1989,4817,32
187,/home/yww/CAS^3/new_data_full_reduce/187/d,Macro,1,3672,3727,4817,55
187,/home/yww/CAS^3/new_data_full_reduce/187/d,Macro,1,4151,4203,4817,52
187,/home/yww/CAS^3/new_data_full_reduce/187/d,Macro,1,4238,4286,4817,48
187,/home/yww/CAS^3/new_data_full_reduce/187/d,Macro,1,4361,4475,4817,114
187,/home/yww/CAS^3/new_data_full_reduce/187/d,Macro,1,4713,4814,4817,101
187,/home/yww/CAS^3/new_data_full_reduce/187/f,Macro,1,695,745,2311,50
187,/home/yww/CAS^3/new_data_full_reduce/187/h,Macro,1,841,933,3506,92
187,/home/yww/CAS^3/new_data_full_reduce/187/i,Macro,1,831,916,4336,85
187,/home/yww/CAS^3/new_data_full_reduce/187/i,Macro,1,973,1059,4336,86
187,/home/yww/CAS^3/new_data_full_reduce/187/k,Macro,1,156,251,2773,95
187,/home/yww/CAS^3/new_data_full_reduce/187/k,Macro,1,876,971,2773,95
187,/home/yww/CAS^3/new_data_full_reduce/187/k,Macro,1,1135,1194,2773,59
187,/home/yww/CAS^3/new_data_full_reduce/187/l,Macro,1,4172,4189,4190,17
188,/home/yww/CAS^3/new_data_full_reduce/188/c,Macro,1,465,550,3471,85
188,/home/yww/CAS^3/new_data_full_reduce/188/d,Macro,1,107,144,4818,37
188,/home/yww/CAS^3/new_data_full_reduce/188/h,Macro,1,2791,2860,3505,69
188,/home/yww/CAS^3/new_data_full_reduce/188/j,Macro,1,5,56,1999,51
188,/home/yww/CAS^3/new_data_full_reduce/188/m,Macro,1,2329,2438,2888,109
189,/home/yww/CAS^3/new_data_full_reduce/189/a,Macro,1,23,123,1019,100
189,/home/yww/CAS^3/new_data_full_reduce/189/a,Macro,1,486,574,1019,88
189,/home/yww/CAS^3/new_data_full_reduce/189/a,Macro,1,952,1017,1019,65
189,/home/yww/CAS^3/new_data_full_reduce/189/a,Micro,2,460,467,1019,7
189,/home/yww/CAS^3/new_data_full_reduce/189/b,Macro,1,3,90,1267,87
189,/home/yww/CAS^3/new_data_full_reduce/189/d,Macro,1,1488,1572,4819,84
189,/home/yww/CAS^3/new_data_full_reduce/189/d,Macro,1,1663,1730,4819,67
189,/home/yww/CAS^3/new_data_full_reduce/189/d,Macro,1,2186,2228,4819,42
189,/home/yww/CAS^3/new_data_full_reduce/189/d,Macro,1,2311,2379,4819,68
189,/home/yww/CAS^3/new_data_full_reduce/189/d,Macro,1,2618,2680,4819,62
189,/home/yww/CAS^3/new_data_full_reduce/189/d,Macro,1,2906,3005,4819,99
189,/home/yww/CAS^3/new_data_full_reduce/189/d,Macro,1,3553,3616,4819,63
189,/home/yww/CAS^3/new_data_full_reduce/189/d,Macro,1,3814,3870,4819,56
189,/home/yww/CAS^3/new_data_full_reduce/189/d,Micro,2,97,103,4819,6
189,/home/yww/CAS^3/new_data_full_reduce/189/d,Micro,2,118,126,4819,8
189,/home/yww/CAS^3/new_data_full_reduce/189/e,Macro,1,36,135,3082,99
189,/home/yww/CAS^3/new_data_full_reduce/189/e,Macro,1,231,337,3082,106
189,/home/yww/CAS^3/new_data_full_reduce/189/e,Macro,1,326,369,3082,43
189,/home/yww/CAS^3/new_data_full_reduce/189/e,Macro,1,710,769,3082,59
189,/home/yww/CAS^3/new_data_full_reduce/189/e,Macro,1,982,1065,3082,83
189,/home/yww/CAS^3/new_data_full_reduce/189/e,Macro,1,1548,1609,3082,61
189,/home/yww/CAS^3/new_data_full_reduce/189/e,Macro,1,1629,1648,3082,19
189,/home/yww/CAS^3/new_data_full_reduce/189/e,Macro,1,2098,2198,3082,100
189,/home/yww/CAS^3/new_data_full_reduce/189/e,Macro,1,2268,2294,3082,26
189,/home/yww/CAS^3/new_data_full_reduce/189/e,Micro,2,141,149,3082,8
189,/home/yww/CAS^3/new_data_full_reduce/189/e,Micro,2,2088,2098,3082,10
189,/home/yww/CAS^3/new_data_full_reduce/189/f,Macro,1,268,380,2311,112
189,/home/yww/CAS^3/new_data_full_reduce/189/f,Micro,2,1381,1388,2311,7
189,/home/yww/CAS^3/new_data_full_reduce/189/g,Macro,1,13,36,2741,23
189,/home/yww/CAS^3/new_data_full_reduce/189/g,Macro,1,56,171,2741,115
189,/home/yww/CAS^3/new_data_full_reduce/189/g,Macro,1,926,962,2741,36
189,/home/yww/CAS^3/new_data_full_reduce/189/g,Macro,1,954,977,2741,23
189,/home/yww/CAS^3/new_data_full_reduce/189/g,Macro,1,1270,1296,2741,26
189,/home/yww/CAS^3/new_data_full_reduce/189/g,Macro,1,1296,1323,2741,27
189,/home/yww/CAS^3/new_data_full_reduce/189/g,Macro,1,1652,1683,2741,31
189,/home/yww/CAS^3/new_data_full_reduce/189/g,Macro,1,1865,1912,2741,47
189,/home/yww/CAS^3/new_data_full_reduce/189/g,Micro,2,37,45,2741,8
189,/home/yww/CAS^3/new_data_full_reduce/189/g,Micro,2,47,56,2741,9
189,/home/yww/CAS^3/new_data_full_reduce/189/g,Micro,2,364,373,2741,9
189,/home/yww/CAS^3/new_data_full_reduce/189/g,Micro,2,908,917,2741,9
189,/home/yww/CAS^3/new_data_full_reduce/189/g,Micro,2,987,1000,2741,13
189,/home/yww/CAS^3/new_data_full_reduce/189/h,Macro,1,121,152,3507,31
189,/home/yww/CAS^3/new_data_full_reduce/189/h,Macro,1,844,910,3507,66
189,/home/yww/CAS^3/new_data_full_reduce/189/h,Macro,1,1087,1177,3507,90
189,/home/yww/CAS^3/new_data_full_reduce/189/h,Macro,1,1225,1277,3507,52
189,/home/yww/CAS^3/new_data_full_reduce/189/h,Macro,1,1637,1701,3507,64
189,/home/yww/CAS^3/new_data_full_reduce/189/h,Macro,1,3176,3262,3507,86
189,/home/yww/CAS^3/new_data_full_reduce/189/h,Macro,1,3268,3288,3507,20
189,/home/yww/CAS^3/new_data_full_reduce/189/h,Micro,2,638,653,3507,15
189,/home/yww/CAS^3/new_data_full_reduce/189/h,Micro,2,2040,2047,3507,7
189,/home/yww/CAS^3/new_data_full_reduce/189/h,Micro,2,2435,2442,3507,7
189,/home/yww/CAS^3/new_data_full_reduce/189/i,Macro,1,20,44,4337,24
189,/home/yww/CAS^3/new_data_full_reduce/189/i,Macro,1,308,383,4337,75
189,/home/yww/CAS^3/new_data_full_reduce/189/i,Macro,1,398,437,4337,39
189,/home/yww/CAS^3/new_data_full_reduce/189/i,Macro,1,1986,2079,4337,93
189,/home/yww/CAS^3/new_data_full_reduce/189/i,Micro,2,1,12,4337,11
189,/home/yww/CAS^3/new_data_full_reduce/189/i,Micro,2,107,116,4337,9
189,/home/yww/CAS^3/new_data_full_reduce/189/i,Micro,2,169,181,4337,12
189,/home/yww/CAS^3/new_data_full_reduce/189/i,Micro,2,267,276,4337,9
189,/home/yww/CAS^3/new_data_full_reduce/189/j,Macro,1,37,74,2000,37
189,/home/yww/CAS^3/new_data_full_reduce/189/j,Macro,1,104,158,2000,54
189,/home/yww/CAS^3/new_data_full_reduce/189/j,Macro,1,217,282,2000,65
189,/home/yww/CAS^3/new_data_full_reduce/189/j,Macro,1,288,322,2000,34
189,/home/yww/CAS^3/new_data_full_reduce/189/j,Macro,1,322,391,2000,69
189,/home/yww/CAS^3/new_data_full_reduce/189/j,Macro,1,654,766,2000,112
189,/home/yww/CAS^3/new_data_full_reduce/189/j,Macro,1,807,833,2000,26
189,/home/yww/CAS^3/new_data_full_reduce/189/j,Macro,1,1948,1998,2000,50
189,/home/yww/CAS^3/new_data_full_reduce/189/j,Micro,2,28,34,2000,6
189,/home/yww/CAS^3/new_data_full_reduce/189/j,Micro,2,52,61,2000,9
189,/home/yww/CAS^3/new_data_full_reduce/189/j,Micro,2,162,167,2000,5
189,/home/yww/CAS^3/new_data_full_reduce/189/k,Macro,1,41,104,2775,63
189,/home/yww/CAS^3/new_data_full_reduce/189/k,Macro,1,391,471,2775,80
189,/home/yww/CAS^3/new_data_full_reduce/189/k,Macro,1,885,991,2775,106
189,/home/yww/CAS^3/new_data_full_reduce/189/k,Macro,1,1046,1071,2775,25
189,/home/yww/CAS^3/new_data_full_reduce/189/k,Macro,1,1627,1725,2775,98
189,/home/yww/CAS^3/new_data_full_reduce/189/k,Macro,1,1912,1995,2775,83
189,/home/yww/CAS^3/new_data_full_reduce/189/k,Micro,2,19,29,2775,10
189,/home/yww/CAS^3/new_data_full_reduce/189/k,Micro,2,281,291,2775,10
189,/home/yww/CAS^3/new_data_full_reduce/189/l,Macro,1,251,282,4190,31
189,/home/yww/CAS^3/new_data_full_reduce/189/l,Macro,1,621,671,4190,50
189,/home/yww/CAS^3/new_data_full_reduce/189/l,Macro,1,1149,1213,4190,64
189,/home/yww/CAS^3/new_data_full_reduce/189/l,Macro,1,2226,2278,4190,52
189,/home/yww/CAS^3/new_data_full_reduce/189/l,Macro,1,3056,3080,4190,24
189,/home/yww/CAS^3/new_data_full_reduce/189/l,Micro,2,214,221,4190,7
189,/home/yww/CAS^3/new_data_full_reduce/189/l,Micro,2,2589,2600,4190,11
189,/home/yww/CAS^3/new_data_full_reduce/189/m,Macro,1,47,80,2889,33
189,/home/yww/CAS^3/new_data_full_reduce/189/m,Macro,1,411,453,2889,42
189,/home/yww/CAS^3/new_data_full_reduce/189/m,Macro,1,841,884,2889,43
189,/home/yww/CAS^3/new_data_full_reduce/189/m,Macro,1,912,964,2889,52
189,/home/yww/CAS^3/new_data_full_reduce/189/m,Macro,1,1779,1872,2889,93
189,/home/yww/CAS^3/new_data_full_reduce/189/m,Micro,2,83,90,2889,7
189,/home/yww/CAS^3/new_data_full_reduce/189/m,Micro,2,90,103,2889,13
189,/home/yww/CAS^3/new_data_full_reduce/189/m,Micro,2,130,145,2889,15
189,/home/yww/CAS^3/new_data_full_reduce/189/m,Micro,2,383,390,2889,7
189,/home/yww/CAS^3/new_data_full_reduce/189/m,Micro,2,776,784,2889,8
190,/home/yww/CAS^3/new_data_full_reduce/190/b,Macro,1,1119,1162,1266,43
190,/home/yww/CAS^3/new_data_full_reduce/190/d,Macro,1,581,656,4817,75
190,/home/yww/CAS^3/new_data_full_reduce/190/e,Macro,1,129,151,3083,22
190,/home/yww/CAS^3/new_data_full_reduce/190/g,Macro,1,956,1033,2739,77
190,/home/yww/CAS^3/new_data_full_reduce/190/h,Macro,1,27,89,3508,62
190,/home/yww/CAS^3/new_data_full_reduce/190/i,Macro,1,43,85,4338,42
190,/home/yww/CAS^3/new_data_full_reduce/190/i,Macro,1,169,226,4338,57
190,/home/yww/CAS^3/new_data_full_reduce/190/j,Macro,1,716,780,1998,64
190,/home/yww/CAS^3/new_data_full_reduce/190/j,Macro,1,814,892,1998,78
190,/home/yww/CAS^3/new_data_full_reduce/190/j,Macro,1,1629,1743,1998,114
190,/home/yww/CAS^3/new_data_full_reduce/190/k,Macro,1,1,70,2775,69
190,/home/yww/CAS^3/new_data_full_reduce/190/k,Macro,1,1081,1160,2775,79
190,/home/yww/CAS^3/new_data_full_reduce/190/k,Macro,1,1221,1304,2775,83
190,/home/yww/CAS^3/new_data_full_reduce/190/k,Macro,1,1325,1409,2775,84
190,/home/yww/CAS^3/new_data_full_reduce/190/l,Macro,1,1,60,4188,59
192,/home/yww/CAS^3/new_data_full_reduce/192/e,Macro,1,2182,2289,3083,107
192,/home/yww/CAS^3/new_data_full_reduce/192/g,Macro,1,53,75,2741,22
192,/home/yww/CAS^3/new_data_full_reduce/192/g,Macro,1,838,869,2741,31
192,/home/yww/CAS^3/new_data_full_reduce/192/h,Macro,1,663,738,3505,75
192,/home/yww/CAS^3/new_data_full_reduce/192/h,Macro,1,954,1002,3505,48
192,/home/yww/CAS^3/new_data_full_reduce/192/i,Macro,1,1116,1132,4337,16
192,/home/yww/CAS^3/new_data_full_reduce/192/i,Macro,1,3654,3771,4337,117
192,/home/yww/CAS^3/new_data_full_reduce/192/j,Macro,1,1745,1795,2000,50
192,/home/yww/CAS^3/new_data_full_reduce/192/m,Macro,1,141,191,2890,50
193,/home/yww/CAS^3/new_data_full_reduce/193/a,Micro,2,576,585,1019,9
193,/home/yww/CAS^3/new_data_full_reduce/193/e,Macro,1,1,57,3082,56
193,/home/yww/CAS^3/new_data_full_reduce/193/e,Micro,2,85,91,3082,6
193,/home/yww/CAS^3/new_data_full_reduce/193/e,Micro,2,103,110,3082,7
193,/home/yww/CAS^3/new_data_full_reduce/193/e,Micro,2,176,184,3082,8
193,/home/yww/CAS^3/new_data_full_reduce/193/e,Micro,2,186,192,3082,6
193,/home/yww/CAS^3/new_data_full_reduce/193/g,Macro,1,312,341,2739,29
193,/home/yww/CAS^3/new_data_full_reduce/193/h,Macro,1,39,126,3508,87
193,/home/yww/CAS^3/new_data_full_reduce/193/h,Macro,1,732,791,3508,59
193,/home/yww/CAS^3/new_data_full_reduce/193/h,Micro,2,12,17,3508,5
193,/home/yww/CAS^3/new_data_full_reduce/193/i,Macro,1,37,97,4339,60
193,/home/yww/CAS^3/new_data_full_reduce/193/k,Macro,1,89,185,2774,96
193,/home/yww/CAS^3/new_data_full_reduce/193/l,Macro,1,409,515,4189,106
193,/home/yww/CAS^3/new_data_full_reduce/193/m,Micro,2,19,27,2889,8
194,/home/yww/CAS^3/new_data_full_reduce/194/a,Macro,1,259,322,1019,63
194,/home/yww/CAS^3/new_data_full_reduce/194/b,Macro,1,1,37,1265,36
194,/home/yww/CAS^3/new_data_full_reduce/194/c,Macro,1,4,35,3472,31
194,/home/yww/CAS^3/new_data_full_reduce/194/c,Macro,1,2034,2099,3472,65
194,/home/yww/CAS^3/new_data_full_reduce/194/d,Macro,1,1861,1884,4818,23
194,/home/yww/CAS^3/new_data_full_reduce/194/d,Micro,2,1884,1899,4818,15
194,/home/yww/CAS^3/new_data_full_reduce/194/e,Macro,1,406,433,3083,27
194,/home/yww/CAS^3/new_data_full_reduce/194/e,Macro,1,550,576,3083,26
194,/home/yww/CAS^3/new_data_full_reduce/194/e,Macro,1,607,635,3083,28
194,/home/yww/CAS^3/new_data_full_reduce/194/e,Macro,1,665,744,3083,79
194,/home/yww/CAS^3/new_data_full_reduce/194/e,Macro,1,839,895,3083,56
194,/home/yww/CAS^3/new_data_full_reduce/194/e,Macro,1,1418,1524,3083,106
194,/home/yww/CAS^3/new_data_full_reduce/194/e,Macro,1,2096,2115,3083,19
194,/home/yww/CAS^3/new_data_full_reduce/194/e,Macro,1,2184,2222,3083,38
194,/home/yww/CAS^3/new_data_full_reduce/194/f,Macro,1,439,503,2309,64
194,/home/yww/CAS^3/new_data_full_reduce/194/g,Macro,1,307,363,2740,56
194,/home/yww/CAS^3/new_data_full_reduce/194/g,Macro,1,360,404,2740,44
194,/home/yww/CAS^3/new_data_full_reduce/194/g,Macro,1,404,485,2740,81
194,/home/yww/CAS^3/new_data_full_reduce/194/g,Macro,1,563,656,2740,93
194,/home/yww/CAS^3/new_data_full_reduce/194/g,Macro,1,873,908,2740,35
194,/home/yww/CAS^3/new_data_full_reduce/194/g,Micro,2,281,296,2740,15
194,/home/yww/CAS^3/new_data_full_reduce/194/h,Macro,1,131,188,3506,57
194,/home/yww/CAS^3/new_data_full_reduce/194/i,Macro,1,154,239,4337,85
194,/home/yww/CAS^3/new_data_full_reduce/194/i,Macro,1,1077,1135,4337,58
194,/home/yww/CAS^3/new_data_full_reduce/194/i,Macro,1,1746,1805,4337,59
194,/home/yww/CAS^3/new_data_full_reduce/194/i,Macro,1,2699,2743,4337,44
194,/home/yww/CAS^3/new_data_full_reduce/194/i,Macro,1,2747,2790,4337,43
194,/home/yww/CAS^3/new_data_full_reduce/194/i,Micro,2,2,14,4337,12
194,/home/yww/CAS^3/new_data_full_reduce/194/j,Macro,1,24,40,1996,16
194,/home/yww/CAS^3/new_data_full_reduce/194/j,Macro,1,63,153,1996,90
194,/home/yww/CAS^3/new_data_full_reduce/194/j,Macro,1,636,729,1996,93
194,/home/yww/CAS^3/new_data_full_reduce/194/j,Macro,1,1118,1154,1996,36
194,/home/yww/CAS^3/new_data_full_reduce/194/j,Macro,1,1203,1236,1996,33
194,/home/yww/CAS^3/new_data_full_reduce/194/j,Macro,1,1554,1597,1996,43
194,/home/yww/CAS^3/new_data_full_reduce/194/j,Macro,1,1628,1670,1996,42
194,/home/yww/CAS^3/new_data_full_reduce/194/k,Macro,1,63,167,2773,104
194,/home/yww/CAS^3/new_data_full_reduce/194/l,Macro,1,695,771,4191,76
194,/home/yww/CAS^3/new_data_full_reduce/194/l,Macro,1,1837,1892,4191,55
194,/home/yww/CAS^3/new_data_full_reduce/194/m,Macro,1,1070,1169,2888,99
194,/home/yww/CAS^3/new_data_full_reduce/194/m,Macro,1,1240,1344,2888,104
194,/home/yww/CAS^3/new_data_full_reduce/194/m,Macro,1,1401,1467,2888,66
194,/home/yww/CAS^3/new_data_full_reduce/194/m,Macro,1,2289,2350,2888,61
195,/home/yww/CAS^3/new_data_full_reduce/195/a,Macro,1,972,1017,1019,45
195,/home/yww/CAS^3/new_data_full_reduce/195/b,Macro,1,48,111,1269,63
195,/home/yww/CAS^3/new_data_full_reduce/195/b,Macro,1,509,549,1269,40
195,/home/yww/CAS^3/new_data_full_reduce/195/b,Macro,1,829,889,1269,60
195,/home/yww/CAS^3/new_data_full_reduce/195/c,Macro,1,48,148,3472,100
195,/home/yww/CAS^3/new_data_full_reduce/195/f,Macro,1,135,187,2310,52
195,/home/yww/CAS^3/new_data_full_reduce/195/g,Macro,1,25,141,2740,116
195,/home/yww/CAS^3/new_data_full_reduce/195/g,Macro,1,1410,1499,2740,89
195,/home/yww/CAS^3/new_data_full_reduce/195/g,Macro,1,2606,2641,2740,35
195,/home/yww/CAS^3/new_data_full_reduce/195/h,Macro,1,427,539,3505,112
195,/home/yww/CAS^3/new_data_full_reduce/195/h,Macro,1,735,822,3505,87
195,/home/yww/CAS^3/new_data_full_reduce/195/h,Macro,1,1141,1226,3505,85
195,/home/yww/CAS^3/new_data_full_reduce/195/h,Macro,1,2140,2183,3505,43
195,/home/yww/CAS^3/new_data_full_reduce/195/h,Macro,1,2774,2835,3505,61
195,/home/yww/CAS^3/new_data_full_reduce/195/i,Macro,1,1,42,4336,41
195,/home/yww/CAS^3/new_data_full_reduce/195/i,Macro,1,2584,2657,4336,73
195,/home/yww/CAS^3/new_data_full_reduce/195/i,Macro,1,2691,2751,4336,60
195,/home/yww/CAS^3/new_data_full_reduce/195/i,Macro,1,3039,3121,4336,82
195,/home/yww/CAS^3/new_data_full_reduce/195/i,Macro,1,4116,4172,4336,56
195,/home/yww/CAS^3/new_data_full_reduce/195/i,Macro,1,4314,4334,4336,20
195,/home/yww/CAS^3/new_data_full_reduce/195/j,Macro,1,8,113,1997,105
195,/home/yww/CAS^3/new_data_full_reduce/195/j,Macro,1,1137,1191,1997,54
195,/home/yww/CAS^3/new_data_full_reduce/195/j,Macro,1,1281,1323,1997,42
195,/home/yww/CAS^3/new_data_full_reduce/195/k,Macro,1,1141,1162,2774,21
195,/home/yww/CAS^3/new_data_full_reduce/195/k,Macro,1,1902,1924,2774,22
195,/home/yww/CAS^3/new_data_full_reduce/195/l,Macro,1,1617,1725,4189,108
195,/home/yww/CAS^3/new_data_full_reduce/195/l,Macro,1,2864,2945,4189,81
195,/home/yww/CAS^3/new_data_full_reduce/195/l,Macro,1,3052,3158,4189,106
195,/home/yww/CAS^3/new_data_full_reduce/195/m,Macro,1,9,87,2886,78
195,/home/yww/CAS^3/new_data_full_reduce/195/m,Macro,1,474,514,2886,40
195,/home/yww/CAS^3/new_data_full_reduce/195/m,Macro,1,1447,1535,2886,88
195,/home/yww/CAS^3/new_data_full_reduce/195/m,Macro,1,2525,2582,2886,57
196,/home/yww/CAS^3/new_data_full_reduce/196/b,Macro,1,852,887,1268,35
196,/home/yww/CAS^3/new_data_full_reduce/196/f,Macro,1,9,57,2310,48
196,/home/yww/CAS^3/new_data_full_reduce/196/f,Macro,1,632,685,2310,53
196,/home/yww/CAS^3/new_data_full_reduce/196/g,Macro,1,545,594,2741,49
196,/home/yww/CAS^3/new_data_full_reduce/196/h,Macro,1,1760,1812,3506,52
196,/home/yww/CAS^3/new_data_full_reduce/196/h,Macro,1,2790,2822,3506,32
196,/home/yww/CAS^3/new_data_full_reduce/196/i,Macro,1,1989,2026,4337,37
196,/home/yww/CAS^3/new_data_full_reduce/196/i,Macro,1,2465,2508,4337,43
196,/home/yww/CAS^3/new_data_full_reduce/196/i,Macro,1,3651,3702,4337,51
196,/home/yww/CAS^3/new_data_full_reduce/196/i,Micro,2,382,395,4337,13
196,/home/yww/CAS^3/new_data_full_reduce/196/k,Macro,1,367,393,2776,26
196,/home/yww/CAS^3/new_data_full_reduce/196/l,Macro,1,1189,1228,4191,39
196,/home/yww/CAS^3/new_data_full_reduce/196/l,Macro,1,2834,2891,4191,57
196,/home/yww/CAS^3/new_data_full_reduce/196/l,Macro,1,3076,3133,4191,57
196,/home/yww/CAS^3/new_data_full_reduce/196/l,Macro,1,3140,3168,4191,28
196,/home/yww/CAS^3/new_data_full_reduce/196/m,Macro,1,89,131,2890,42
196,/home/yww/CAS^3/new_data_full_reduce/196/m,Macro,1,930,975,2890,45
196,/home/yww/CAS^3/new_data_full_reduce/196/m,Macro,1,1944,1992,2890,48
196,/home/yww/CAS^3/new_data_full_reduce/196/m,Macro,1,2687,2717,2890,30
197,/home/yww/CAS^3/new_data_full_reduce/197/a,Macro,1,437,457,1021,20
197,/home/yww/CAS^3/new_data_full_reduce/197/a,Macro,1,657,745,1021,88
197,/home/yww/CAS^3/new_data_full_reduce/197/d,Macro,1,1185,1203,4819,18
197,/home/yww/CAS^3/new_data_full_reduce/197/d,Macro,1,2678,2704,4819,26
197,/home/yww/CAS^3/new_data_full_reduce/197/d,Macro,1,3201,3241,4819,40
197,/home/yww/CAS^3/new_data_full_reduce/197/d,Macro,1,3356,3393,4819,37
197,/home/yww/CAS^3/new_data_full_reduce/197/g,Macro,1,178,207,2746,29
197,/home/yww/CAS^3/new_data_full_reduce/197/g,Macro,1,783,823,2746,40
197,/home/yww/CAS^3/new_data_full_reduce/197/g,Macro,1,1509,1560,2746,51
197,/home/yww/CAS^3/new_data_full_reduce/197/h,Macro,1,2379,2439,3512,60
197,/home/yww/CAS^3/new_data_full_reduce/197/h,Macro,1,3086,3160,3512,74
197,/home/yww/CAS^3/new_data_full_reduce/197/i,Macro,1,264,307,4343,43
197,/home/yww/CAS^3/new_data_full_reduce/197/i,Macro,1,926,982,4343,56
197,/home/yww/CAS^3/new_data_full_reduce/197/i,Micro,2,1809,1821,4343,12
197,/home/yww/CAS^3/new_data_full_reduce/197/j,Macro,1,20,78,1998,58
197,/home/yww/CAS^3/new_data_full_reduce/197/j,Macro,1,773,798,1998,25
197,/home/yww/CAS^3/new_data_full_reduce/197/l,Macro,1,2025,2057,4191,32
197,/home/yww/CAS^3/new_data_full_reduce/197/l,Macro,1,2220,2250,4191,30
197,/home/yww/CAS^3/new_data_full_reduce/197/l,Macro,1,3135,3174,4191,39
197,/home/yww/CAS^3/new_data_full_reduce/197/l,Micro,2,658,670,4191,12
197,/home/yww/CAS^3/new_data_full_reduce/197/l,Micro,2,929,944,4191,15
197,/home/yww/CAS^3/new_data_full_reduce/197/l,Micro,2,1991,2000,4191,9
197,/home/yww/CAS^3/new_data_full_reduce/197/m,Macro,1,52,102,2890,50
197,/home/yww/CAS^3/new_data_full_reduce/197/m,Macro,1,904,926,2890,22
197,/home/yww/CAS^3/new_data_full_reduce/197/m,Macro,1,1307,1341,2890,34
197,/home/yww/CAS^3/new_data_full_reduce/197/m,Macro,1,1549,1575,2890,26
198,/home/yww/CAS^3/new_data_full_reduce/198/b,Macro,1,1,105,1265,104
198,/home/yww/CAS^3/new_data_full_reduce/198/b,Macro,1,958,994,1265,36
198,/home/yww/CAS^3/new_data_full_reduce/198/e,Macro,1,33,132,3082,99
198,/home/yww/CAS^3/new_data_full_reduce/198/j,Macro,1,48,101,1999,53
198,/home/yww/CAS^3/new_data_full_reduce/198/j,Macro,1,163,278,1999,115
198,/home/yww/CAS^3/new_data_full_reduce/198/j,Macro,1,477,547,1999,70
198,/home/yww/CAS^3/new_data_full_reduce/198/j,Macro,1,1648,1739,1999,91
198,/home/yww/CAS^3/new_data_full_reduce/198/j,Macro,1,1762,1873,1999,111
198,/home/yww/CAS^3/new_data_full_reduce/198/k,Macro,1,189,242,2775,53
198,/home/yww/CAS^3/new_data_full_reduce/198/k,Macro,1,1940,2029,2775,89
198,/home/yww/CAS^3/new_data_full_reduce/198/k,Macro,1,2642,2686,2775,44
200,/home/yww/CAS^3/new_data_full_reduce/200/a,Macro,1,174,215,1020,41
200,/home/yww/CAS^3/new_data_full_reduce/200/b,Macro,1,292,340,1253,48
200,/home/yww/CAS^3/new_data_full_reduce/200/b,Micro,2,512,527,1253,15
200,/home/yww/CAS^3/new_data_full_reduce/200/d,Macro,1,676,774,4817,98
200,/home/yww/CAS^3/new_data_full_reduce/200/d,Macro,1,3800,3858,4817,58
200,/home/yww/CAS^3/new_data_full_reduce/200/d,Macro,1,4642,4704,4817,62
200,/home/yww/CAS^3/new_data_full_reduce/200/e,Macro,1,2326,2417,3083,91
200,/home/yww/CAS^3/new_data_full_reduce/200/e,Macro,1,2460,2564,3083,104
200,/home/yww/CAS^3/new_data_full_reduce/200/e,Macro,1,3054,3081,3083,27
200,/home/yww/CAS^3/new_data_full_reduce/200/f,Macro,1,506,582,2311,76
200,/home/yww/CAS^3/new_data_full_reduce/200/g,Macro,1,2451,2523,2740,72
200,/home/yww/CAS^3/new_data_full_reduce/200/k,Macro,1,454,551,2774,97
200,/home/yww/CAS^3/new_data_full_reduce/200/m,Macro,1,43,87,2890,44
200,/home/yww/CAS^3/new_data_full_reduce/200/m,Macro,1,159,267,2890,108
201,/home/yww/CAS^3/new_data_full_reduce/201/a,Macro,1,991,1017,1019,26
201,/home/yww/CAS^3/new_data_full_reduce/201/c,Macro,1,336,354,3471,18
201,/home/yww/CAS^3/new_data_full_reduce/201/c,Macro,1,1815,1849,3471,34
201,/home/yww/CAS^3/new_data_full_reduce/201/c,Macro,1,2558,2587,3471,29
201,/home/yww/CAS^3/new_data_full_reduce/201/d,Macro,1,101,121,4818,20
201,/home/yww/CAS^3/new_data_full_reduce/201/d,Macro,1,2676,2775,4818,99
201,/home/yww/CAS^3/new_data_full_reduce/201/d,Macro,1,3355,3443,4818,88
201,/home/yww/CAS^3/new_data_full_reduce/201/d,Macro,1,3660,3704,4818,44
201,/home/yww/CAS^3/new_data_full_reduce/201/e,Macro,1,1203,1271,3082,68
201,/home/yww/CAS^3/new_data_full_reduce/201/e,Macro,1,1281,1340,3082,59
201,/home/yww/CAS^3/new_data_full_reduce/201/e,Macro,1,1600,1621,3082,21
201,/home/yww/CAS^3/new_data_full_reduce/201/e,Macro,1,1927,1943,3082,16
201,/home/yww/CAS^3/new_data_full_reduce/201/e,Macro,1,2007,2042,3082,35
201,/home/yww/CAS^3/new_data_full_reduce/201/e,Micro,2,592,603,3082,11
201,/home/yww/CAS^3/new_data_full_reduce/201/e,Micro,2,1896,1907,3082,11
201,/home/yww/CAS^3/new_data_full_reduce/201/f,Macro,1,1935,1963,2309,28
201,/home/yww/CAS^3/new_data_full_reduce/201/f,Macro,1,1973,2006,2309,33
201,/home/yww/CAS^3/new_data_full_reduce/201/f,Macro,1,2019,2039,2309,20
201,/home/yww/CAS^3/new_data_full_reduce/201/g,Macro,1,7,123,2737,116
201,/home/yww/CAS^3/new_data_full_reduce/201/g,Macro,1,204,225,2737,21
201,/home/yww/CAS^3/new_data_full_reduce/201/g,Macro,1,438,479,2737,41
201,/home/yww/CAS^3/new_data_full_reduce/201/g,Macro,1,1761,1798,2737,37
201,/home/yww/CAS^3/new_data_full_reduce/201/g,Micro,2,159,169,2737,10
201,/home/yww/CAS^3/new_data_full_reduce/201/h,Macro,1,21,123,3506,102
201,/home/yww/CAS^3/new_data_full_reduce/201/i,Macro,1,2,24,4335,22
201,/home/yww/CAS^3/new_data_full_reduce/201/i,Macro,1,280,320,4335,40
201,/home/yww/CAS^3/new_data_full_reduce/201/i,Macro,1,1610,1630,4335,20
201,/home/yww/CAS^3/new_data_full_reduce/201/i,Macro,1,1669,1694,4335,25
201,/home/yww/CAS^3/new_data_full_reduce/201/i,Macro,1,2173,2244,4335,71
201,/home/yww/CAS^3/new_data_full_reduce/201/i,Macro,1,2304,2384,4335,80
201,/home/yww/CAS^3/new_data_full_reduce/201/i,Macro,1,2731,2825,4335,94
201,/home/yww/CAS^3/new_data_full_reduce/201/i,Macro,1,3853,3878,4335,25
201,/home/yww/CAS^3/new_data_full_reduce/201/i,Micro,2,44,56,4335,12
201,/home/yww/CAS^3/new_data_full_reduce/201/i,Micro,2,55,60,4335,5
201,/home/yww/CAS^3/new_data_full_reduce/201/j,Macro,1,1776,1815,2000,39
201,/home/yww/CAS^3/new_data_full_reduce/201/k,Macro,1,1,66,2773,65
201,/home/yww/CAS^3/new_data_full_reduce/201/l,Macro,1,216,257,4189,41
201,/home/yww/CAS^3/new_data_full_reduce/201/l,Macro,1,948,973,4189,25
201,/home/yww/CAS^3/new_data_full_reduce/201/l,Macro,1,1557,1626,4189,69
201,/home/yww/CAS^3/new_data_full_reduce/201/m,Macro,1,1027,1045,2890,18
201,/home/yww/CAS^3/new_data_full_reduce/201/m,Macro,1,1058,1077,2890,19
201,/home/yww/CAS^3/new_data_full_reduce/201/m,Micro,2,354,363,2890,9
202,/home/yww/CAS^3/new_data_full_reduce/202/b,Macro,1,73,113,1265,40
202,/home/yww/CAS^3/new_data_full_reduce/202/b,Macro,1,336,439,1265,103
202,/home/yww/CAS^3/new_data_full_reduce/202/b,Micro,2,59,73,1265,14
202,/home/yww/CAS^3/new_data_full_reduce/202/c,Macro,1,56,96,3471,40
202,/home/yww/CAS^3/new_data_full_reduce/202/d,Macro,1,793,846,4818,53
202,/home/yww/CAS^3/new_data_full_reduce/202/e,Macro,1,1336,1423,3083,87
202,/home/yww/CAS^3/new_data_full_reduce/202/f,Macro,1,336,432,2308,96
202,/home/yww/CAS^3/new_data_full_reduce/202/f,Micro,2,39,54,2308,15
202,/home/yww/CAS^3/new_data_full_reduce/202/g,Macro,1,1888,1964,2741,76
202,/home/yww/CAS^3/new_data_full_reduce/202/g,Macro,1,2672,2728,2741,56
202,/home/yww/CAS^3/new_data_full_reduce/202/g,Micro,2,389,397,2741,8
202,/home/yww/CAS^3/new_data_full_reduce/202/i,Macro,1,1990,2037,4335,47
202,/home/yww/CAS^3/new_data_full_reduce/202/j,Macro,1,14,63,1998,49
202,/home/yww/CAS^3/new_data_full_reduce/202/j,Macro,1,504,544,1998,40
202,/home/yww/CAS^3/new_data_full_reduce/202/j,Macro,1,1589,1658,1998,69
202,/home/yww/CAS^3/new_data_full_reduce/202/l,Macro,1,1267,1327,4191,60
202,/home/yww/CAS^3/new_data_full_reduce/202/l,Macro,1,3277,3335,4191,58
202,/home/yww/CAS^3/new_data_full_reduce/202/l,Macro,1,3434,3478,4191,44
202,/home/yww/CAS^3/new_data_full_reduce/202/l,Micro,2,1,16,4191,15
203,/home/yww/CAS^3/new_data_full_reduce/203/a,Macro,1,57,101,1020,44
203,/home/yww/CAS^3/new_data_full_reduce/203/a,Macro,1,966,1018,1020,52
203,/home/yww/CAS^3/new_data_full_reduce/203/b,Macro,1,1,50,1267,49
203,/home/yww/CAS^3/new_data_full_reduce/203/c,Macro,1,140,178,3471,38
203,/home/yww/CAS^3/new_data_full_reduce/203/c,Macro,1,2536,2652,3471,116
203,/home/yww/CAS^3/new_data_full_reduce/203/d,Macro,1,1690,1772,4819,82
203,/home/yww/CAS^3/new_data_full_reduce/203/d,Macro,1,4314,4404,4819,90
203,/home/yww/CAS^3/new_data_full_reduce/203/e,Macro,1,122,211,3083,89
203,/home/yww/CAS^3/new_data_full_reduce/203/e,Macro,1,427,470,3083,43
203,/home/yww/CAS^3/new_data_full_reduce/203/e,Macro,1,470,536,3083,66
203,/home/yww/CAS^3/new_data_full_reduce/203/e,Macro,1,2706,2810,3083,104
203,/home/yww/CAS^3/new_data_full_reduce/203/f,Macro,1,52,156,2308,104
203,/home/yww/CAS^3/new_data_full_reduce/203/f,Macro,1,156,204,2308,48
203,/home/yww/CAS^3/new_data_full_reduce/203/f,Macro,1,908,1004,2308,96
203,/home/yww/CAS^3/new_data_full_reduce/203/f,Macro,1,1377,1457,2308,80
203,/home/yww/CAS^3/new_data_full_reduce/203/f,Macro,1,1457,1535,2308,78
203,/home/yww/CAS^3/new_data_full_reduce/203/f,Macro,1,2226,2306,2308,80
203,/home/yww/CAS^3/new_data_full_reduce/203/g,Macro,1,1,104,2740,103
203,/home/yww/CAS^3/new_data_full_reduce/203/g,Macro,1,138,183,2740,45
203,/home/yww/CAS^3/new_data_full_reduce/203/g,Macro,1,183,235,2740,52
203,/home/yww/CAS^3/new_data_full_reduce/203/g,Macro,1,247,293,2740,46
203,/home/yww/CAS^3/new_data_full_reduce/203/g,Macro,1,305,361,2740,56
203,/home/yww/CAS^3/new_data_full_reduce/203/g,Macro,1,1198,1279,2740,81
203,/home/yww/CAS^3/new_data_full_reduce/203/h,Macro,1,185,280,3505,95
203,/home/yww/CAS^3/new_data_full_reduce/203/h,Macro,1,1152,1257,3505,105
203,/home/yww/CAS^3/new_data_full_reduce/203/h,Macro,1,1598,1627,3505,29
203,/home/yww/CAS^3/new_data_full_reduce/203/i,Macro,1,3561,3611,4337,50
204,/home/yww/CAS^3/new_data_full_reduce/204/a,Macro,1,7,64,1019,57
204,/home/yww/CAS^3/new_data_full_reduce/204/a,Macro,1,64,122,1019,58
204,/home/yww/CAS^3/new_data_full_reduce/204/a,Macro,1,121,176,1019,55
204,/home/yww/CAS^3/new_data_full_reduce/204/a,Macro,1,330,360,1019,30
204,/home/yww/CAS^3/new_data_full_reduce/204/a,Macro,1,824,851,1019,27
204,/home/yww/CAS^3/new_data_full_reduce/204/b,Macro,1,14,72,1269,58
204,/home/yww/CAS^3/new_data_full_reduce/204/b,Macro,1,747,779,1269,32
204,/home/yww/CAS^3/new_data_full_reduce/204/d,Macro,1,36,118,4818,82
204,/home/yww/CAS^3/new_data_full_reduce/204/e,Macro,1,246,353,3083,107
204,/home/yww/CAS^3/new_data_full_reduce/204/e,Macro,1,1616,1645,3083,29
204,/home/yww/CAS^3/new_data_full_reduce/204/e,Macro,1,2308,2332,3083,24
204,/home/yww/CAS^3/new_data_full_reduce/204/e,Macro,1,2333,2427,3083,94
204,/home/yww/CAS^3/new_data_full_reduce/204/g,Macro,1,31,65,2740,34
204,/home/yww/CAS^3/new_data_full_reduce/204/j,Macro,1,26,102,2001,76
204,/home/yww/CAS^3/new_data_full_reduce/204/j,Macro,1,286,349,2001,63
204,/home/yww/CAS^3/new_data_full_reduce/204/j,Macro,1,810,837,2001,27
204,/home/yww/CAS^3/new_data_full_reduce/204/j,Macro,1,953,1014,2001,61
204,/home/yww/CAS^3/new_data_full_reduce/204/j,Macro,1,1454,1499,2001,45
204,/home/yww/CAS^3/new_data_full_reduce/204/j,Macro,1,1783,1845,2001,62
204,/home/yww/CAS^3/new_data_full_reduce/204/j,Micro,2,693,702,2001,9
204,/home/yww/CAS^3/new_data_full_reduce/204/k,Macro,1,122,177,2773,55
204,/home/yww/CAS^3/new_data_full_reduce/204/k,Macro,1,776,836,2773,60
204,/home/yww/CAS^3/new_data_full_reduce/204/k,Macro,1,846,916,2773,70
204,/home/yww/CAS^3/new_data_full_reduce/204/k,Macro,1,1952,2042,2773,90
204,/home/yww/CAS^3/new_data_full_reduce/204/k,Macro,1,2702,2738,2773,36
204,/home/yww/CAS^3/new_data_full_reduce/204/l,Macro,1,1,52,4191,51
204,/home/yww/CAS^3/new_data_full_reduce/204/l,Macro,1,80,135,4191,55
206,/home/yww/CAS^3/new_data_full_reduce/206/a,Macro,1,33,81,1007,48
206,/home/yww/CAS^3/new_data_full_reduce/206/a,Micro,2,10,24,1007,14
206,/home/yww/CAS^3/new_data_full_reduce/206/c,Micro,2,65,76,3217,11
206,/home/yww/CAS^3/new_data_full_reduce/206/e,Macro,1,7,35,2791,28
206,/home/yww/CAS^3/new_data_full_reduce/206/e,Micro,2,1126,1135,2791,9
206,/home/yww/CAS^3/new_data_full_reduce/206/f,Micro,2,27,42,2134,15
206,/home/yww/CAS^3/new_data_full_reduce/206/g,Macro,1,1,64,2666,63
206,/home/yww/CAS^3/new_data_full_reduce/206/h,Micro,2,31,42,3178,11
206,/home/yww/CAS^3/new_data_full_reduce/206/h,Micro,2,71,86,3178,15
206,/home/yww/CAS^3/new_data_full_reduce/206/h,Micro,2,328,335,3178,7
206,/home/yww/CAS^3/new_data_full_reduce/206/j,Micro,2,16,27,1870,11
206,/home/yww/CAS^3/new_data_full_reduce/206/k,Macro,1,11,80,2715,69
206,/home/yww/CAS^3/new_data_full_reduce/206/k,Micro,2,1584,1597,2715,13
206,/home/yww/CAS^3/new_data_full_reduce/206/l,Micro,2,2597,2609,3876,12
207,/home/yww/CAS^3/new_data_full_reduce/207/a,Macro,1,28,111,977,83
207,/home/yww/CAS^3/new_data_full_reduce/207/a,Macro,1,212,245,977,33
207,/home/yww/CAS^3/new_data_full_reduce/207/a,Macro,1,445,469,977,24
207,/home/yww/CAS^3/new_data_full_reduce/207/b,Macro,1,80,124,1204,44
207,/home/yww/CAS^3/new_data_full_reduce/207/c,Micro,2,358,372,3231,14
207,/home/yww/CAS^3/new_data_full_reduce/207/d,Macro,1,217,268,4710,51
207,/home/yww/CAS^3/new_data_full_reduce/207/d,Macro,1,323,369,4710,46
207,/home/yww/CAS^3/new_data_full_reduce/207/e,Macro,1,1703,1737,2895,34
207,/home/yww/CAS^3/new_data_full_reduce/207/e,Macro,1,1800,1857,2895,57
207,/home/yww/CAS^3/new_data_full_reduce/207/e,Micro,2,400,410,2895,10
207,/home/yww/CAS^3/new_data_full_reduce/207/j,Macro,1,52,89,1876,37
207,/home/yww/CAS^3/new_data_full_reduce/207/j,Macro,1,1320,1363,1876,43
207,/home/yww/CAS^3/new_data_full_reduce/207/k,Macro,1,23,66,2589,43
207,/home/yww/CAS^3/new_data_full_reduce/207/l,Macro,1,100,122,3864,22
207,/home/yww/CAS^3/new_data_full_reduce/207/m,Macro,1,89,145,2807,56
208,/home/yww/CAS^3/new_data_full_reduce/208/a,Macro,1,24,62,787,38
208,/home/yww/CAS^3/new_data_full_reduce/208/a,Macro,1,148,212,787,64
208,/home/yww/CAS^3/new_data_full_reduce/208/a,Macro,1,363,435,787,72
208,/home/yww/CAS^3/new_data_full_reduce/208/a,Macro,1,435,543,787,108
208,/home/yww/CAS^3/new_data_full_reduce/208/a,Macro,1,543,610,787,67
208,/home/yww/CAS^3/new_data_full_reduce/208/a,Macro,1,621,691,787,70
208,/home/yww/CAS^3/new_data_full_reduce/208/b,Macro,1,88,114,965,26
208,/home/yww/CAS^3/new_data_full_reduce/208/c,Macro,1,449,496,2773,47
208,/home/yww/CAS^3/new_data_full_reduce/208/c,Macro,1,515,548,2773,33
208,/home/yww/CAS^3/new_data_full_reduce/208/c,Macro,1,595,626,2773,31
208,/home/yww/CAS^3/new_data_full_reduce/208/c,Macro,1,1736,1765,2773,29
208,/home/yww/CAS^3/new_data_full_reduce/208/c,Macro,1,2076,2123,2773,47
208,/home/yww/CAS^3/new_data_full_reduce/208/c,Macro,1,2215,2259,2773,44
208,/home/yww/CAS^3/new_data_full_reduce/208/c,Macro,1,2411,2494,2773,83
208,/home/yww/CAS^3/new_data_full_reduce/208/c,Macro,1,2569,2654,2773,85
208,/home/yww/CAS^3/new_data_full_reduce/208/d,Macro,1,2159,2249,3660,90
208,/home/yww/CAS^3/new_data_full_reduce/208/d,Macro,1,2497,2545,3660,48
208,/home/yww/CAS^3/new_data_full_reduce/208/d,Micro,2,1005,1020,3660,15
208,/home/yww/CAS^3/new_data_full_reduce/208/d,Micro,2,2131,2139,3660,8
208,/home/yww/CAS^3/new_data_full_reduce/208/e,Micro,2,933,948,2475,15
208,/home/yww/CAS^3/new_data_full_reduce/208/f,Macro,1,92,121,1899,29
208,/home/yww/CAS^3/new_data_full_reduce/208/g,Macro,1,651,727,2139,76
208,/home/yww/CAS^3/new_data_full_reduce/208/g,Macro,1,886,915,2139,29
208,/home/yww/CAS^3/new_data_full_reduce/208/i,Macro,1,2659,2699,3366,40
208,/home/yww/CAS^3/new_data_full_reduce/208/j,Macro,1,130,170,1608,40
208,/home/yww/CAS^3/new_data_full_reduce/208/j,Macro,1,1377,1424,1608,47
208,/home/yww/CAS^3/new_data_full_reduce/208/j,Macro,1,1424,1453,1608,29
208,/home/yww/CAS^3/new_data_full_reduce/208/k,Macro,1,580,679,2316,99
208,/home/yww/CAS^3/new_data_full_reduce/208/k,Macro,1,1977,2021,2316,44
208,/home/yww/CAS^3/new_data_full_reduce/208/m,Macro,1,659,686,2267,27
208,/home/yww/CAS^3/new_data_full_reduce/208/m,Macro,1,803,825,2267,22
208,/home/yww/CAS^3/new_data_full_reduce/208/m,Macro,1,1300,1328,2267,28
208,/home/yww/CAS^3/new_data_full_reduce/208/m,Micro,2,47,55,2267,8
209,/home/yww/CAS^3/new_data_full_reduce/209/b,Macro,1,3,51,1083,48
209,/home/yww/CAS^3/new_data_full_reduce/209/b,Macro,1,51,155,1083,104
209,/home/yww/CAS^3/new_data_full_reduce/209/b,Macro,1,649,740,1083,91
209,/home/yww/CAS^3/new_data_full_reduce/209/d,Macro,1,3449,3505,3941,56
209,/home/yww/CAS^3/new_data_full_reduce/209/d,Macro,1,3604,3653,3941,49
209,/home/yww/CAS^3/new_data_full_reduce/209/e,Macro,1,334,371,2369,37
209,/home/yww/CAS^3/new_data_full_reduce/209/h,Macro,1,1871,1905,2776,34
209,/home/yww/CAS^3/new_data_full_reduce/209/h,Macro,1,1983,2022,2776,39
209,/home/yww/CAS^3/new_data_full_reduce/209/i,Macro,1,1333,1389,3446,56
209,/home/yww/CAS^3/new_data_full_reduce/209/i,Macro,1,2598,2629,3446,31
209,/home/yww/CAS^3/new_data_full_reduce/209/i,Macro,1,3230,3268,3446,38
209,/home/yww/CAS^3/new_data_full_reduce/209/j,Macro,1,742,814,1544,72
209,/home/yww/CAS^3/new_data_full_reduce/209/j,Macro,1,1369,1447,1544,78
209,/home/yww/CAS^3/new_data_full_reduce/209/l,Macro,1,3130,3163,3251,33
209,/home/yww/CAS^3/new_data_full_reduce/209/m,Macro,1,5,41,2236,36
209,/home/yww/CAS^3/new_data_full_reduce/209/m,Macro,1,1710,1754,2236,44
209,/home/yww/CAS^3/new_data_full_reduce/209/m,Macro,1,2109,2142,2236,33
210,/home/yww/CAS^3/new_data_full_reduce/210/d,Macro,1,54,90,4040,36
210,/home/yww/CAS^3/new_data_full_reduce/210/e,Macro,1,1,38,2593,37
210,/home/yww/CAS^3/new_data_full_reduce/210/i,Macro,1,2470,2518,3788,48
210,/home/yww/CAS^3/new_data_full_reduce/210/j,Macro,1,2,68,1712,66
210,/home/yww/CAS^3/new_data_full_reduce/210/m,Micro,2,1,15,2531,14
212,/home/yww/CAS^3/new_data_full_reduce/212/j,Micro,2,1122,1132,1734,10
213,/home/yww/CAS^3/new_data_full_reduce/213/g,Macro,1,5,62,2323,57
214,/home/yww/CAS^3/new_data_full_reduce/214/b,Micro,2,1,12,1189,11
215,/home/yww/CAS^3/new_data_full_reduce/215/a,Macro,1,51,112,916,61
215,/home/yww/CAS^3/new_data_full_reduce/215/b,Micro,2,38,48,1180,10
215,/home/yww/CAS^3/new_data_full_reduce/215/b,Micro,2,891,898,1180,7
215,/home/yww/CAS^3/new_data_full_reduce/215/c,Macro,1,1,65,3207,64
215,/home/yww/CAS^3/new_data_full_reduce/215/e,Macro,1,105,137,2704,32
215,/home/yww/CAS^3/new_data_full_reduce/215/f,Macro,1,534,554,2079,20
215,/home/yww/CAS^3/new_data_full_reduce/215/g,Macro,1,21,101,2542,80
215,/home/yww/CAS^3/new_data_full_reduce/215/j,Macro,1,1,66,1829,65
215,/home/yww/CAS^3/new_data_full_reduce/215/j,Micro,2,661,671,1829,10
215,/home/yww/CAS^3/new_data_full_reduce/215/k,Macro,1,62,97,2487,35
215,/home/yww/CAS^3/new_data_full_reduce/215/k,Macro,1,114,151,2487,37
215,/home/yww/CAS^3/new_data_full_reduce/215/k,Macro,1,1072,1097,2487,25
215,/home/yww/CAS^3/new_data_full_reduce/215/k,Macro,1,2355,2373,2487,18
215,/home/yww/CAS^3/new_data_full_reduce/215/l,Macro,1,2876,2910,3873,34
215,/home/yww/CAS^3/new_data_full_reduce/215/m,Macro,1,30,67,2684,37
215,/home/yww/CAS^3/new_data_full_reduce/215/m,Macro,1,143,177,2684,34
216,/home/yww/CAS^3/new_data_full_reduce/216/a,Macro,1,156,194,1022,38
216,/home/yww/CAS^3/new_data_full_reduce/216/a,Macro,1,226,271,1022,45
216,/home/yww/CAS^3/new_data_full_reduce/216/a,Micro,2,921,936,1022,15
216,/home/yww/CAS^3/new_data_full_reduce/216/b,Macro,1,791,813,1271,22
216,/home/yww/CAS^3/new_data_full_reduce/216/b,Macro,1,1033,1076,1271,43
216,/home/yww/CAS^3/new_data_full_reduce/216/b,Macro,1,1076,1142,1271,66
216,/home/yww/CAS^3/new_data_full_reduce/216/b,Macro,1,1157,1269,1271,112
216,/home/yww/CAS^3/new_data_full_reduce/216/c,Macro,1,1044,1079,3473,35
216,/home/yww/CAS^3/new_data_full_reduce/216/d,Macro,1,167,204,4820,37
216,/home/yww/CAS^3/new_data_full_reduce/216/d,Macro,1,1043,1163,4820,120
216,/home/yww/CAS^3/new_data_full_reduce/216/d,Macro,1,2014,2071,4820,57
216,/home/yww/CAS^3/new_data_full_reduce/216/d,Macro,1,2272,2325,4820,53
216,/home/yww/CAS^3/new_data_full_reduce/216/d,Macro,1,2386,2444,4820,58
216,/home/yww/CAS^3/new_data_full_reduce/216/d,Macro,1,2475,2534,4820,59
216,/home/yww/CAS^3/new_data_full_reduce/216/d,Macro,1,2742,2791,4820,49
216,/home/yww/CAS^3/new_data_full_reduce/216/d,Macro,1,2822,2871,4820,49
216,/home/yww/CAS^3/new_data_full_reduce/216/d,Macro,1,3056,3120,4820,64
216,/home/yww/CAS^3/new_data_full_reduce/216/d,Macro,1,3930,3982,4820,52
216,/home/yww/CAS^3/new_data_full_reduce/216/e,Macro,1,285,323,3087,38
216,/home/yww/CAS^3/new_data_full_reduce/216/e,Macro,1,1109,1182,3087,73
216,/home/yww/CAS^3/new_data_full_reduce/216/e,Macro,1,2753,2769,3087,16
216,/home/yww/CAS^3/new_data_full_reduce/216/e,Macro,1,2805,2872,3087,67
216,/home/yww/CAS^3/new_data_full_reduce/216/f,Macro,1,185,220,2311,35
216,/home/yww/CAS^3/new_data_full_reduce/216/f,Macro,1,277,343,2311,66
216,/home/yww/CAS^3/new_data_full_reduce/216/f,Macro,1,937,1014,2311,77
216,/home/yww/CAS^3/new_data_full_reduce/216/g,Macro,1,35,97,2293,62
216,/home/yww/CAS^3/new_data_full_reduce/216/g,Macro,1,329,377,2293,48
216,/home/yww/CAS^3/new_data_full_reduce/216/g,Macro,1,523,565,2293,42
216,/home/yww/CAS^3/new_data_full_reduce/216/g,Macro,1,1227,1276,2293,49
216,/home/yww/CAS^3/new_data_full_reduce/216/g,Macro,1,1418,1455,2293,37
216,/home/yww/CAS^3/new_data_full_reduce/216/g,Macro,1,1512,1542,2293,30
216,/home/yww/CAS^3/new_data_full_reduce/216/g,Macro,1,1753,1781,2293,28
216,/home/yww/CAS^3/new_data_full_reduce/216/g,Macro,1,2156,2195,2293,39
216,/home/yww/CAS^3/new_data_full_reduce/216/g,Macro,1,2237,2285,2293,48
216,/home/yww/CAS^3/new_data_full_reduce/216/h,Macro,1,625,660,2953,35
216,/home/yww/CAS^3/new_data_full_reduce/216/h,Macro,1,756,797,2953,41
216,/home/yww/CAS^3/new_data_full_reduce/216/h,Macro,1,1187,1233,2953,46
216,/home/yww/CAS^3/new_data_full_reduce/216/h,Macro,1,1284,1323,2953,39
216,/home/yww/CAS^3/new_data_full_reduce/216/h,Macro,1,1348,1399,2953,51
216,/home/yww/CAS^3/new_data_full_reduce/216/h,Macro,1,1510,1544,2953,34
216,/home/yww/CAS^3/new_data_full_reduce/216/h,Macro,1,2120,2170,2953,50
216,/home/yww/CAS^3/new_data_full_reduce/216/h,Macro,1,2189,2215,2953,26
216,/home/yww/CAS^3/new_data_full_reduce/216/h,Macro,1,2380,2431,2953,51
216,/home/yww/CAS^3/new_data_full_reduce/216/h,Macro,1,2439,2513,2953,74
216,/home/yww/CAS^3/new_data_full_reduce/216/h,Micro,2,1788,1800,2953,12
216,/home/yww/CAS^3/new_data_full_reduce/216/i,Macro,1,1175,1258,4339,83
216,/home/yww/CAS^3/new_data_full_reduce/216/i,Macro,1,1262,1338,4339,76
216,/home/yww/CAS^3/new_data_full_reduce/216/i,Macro,1,1760,1816,4339,56
216,/home/yww/CAS^3/new_data_full_reduce/216/i,Macro,1,2955,2999,4339,44
216,/home/yww/CAS^3/new_data_full_reduce/216/i,Macro,1,3420,3493,4339,73
216,/home/yww/CAS^3/new_data_full_reduce/216/i,Macro,1,3652,3747,4339,95
216,/home/yww/CAS^3/new_data_full_reduce/216/i,Macro,1,3751,3806,4339,55
216,/home/yww/CAS^3/new_data_full_reduce/216/j,Macro,1,166,229,2001,63
216,/home/yww/CAS^3/new_data_full_reduce/216/j,Macro,1,477,494,2001,17
216,/home/yww/CAS^3/new_data_full_reduce/216/j,Macro,1,1341,1379,2001,38
216,/home/yww/CAS^3/new_data_full_reduce/216/j,Macro,1,1719,1779,2001,60
216,/home/yww/CAS^3/new_data_full_reduce/216/k,Macro,1,252,298,2776,46
216,/home/yww/CAS^3/new_data_full_reduce/216/k,Macro,1,1915,1999,2776,84
216,/home/yww/CAS^3/new_data_full_reduce/216/k,Macro,1,2153,2236,2776,83
216,/home/yww/CAS^3/new_data_full_reduce/216/l,Macro,1,1097,1151,4191,54
216,/home/yww/CAS^3/new_data_full_reduce/216/l,Macro,1,1239,1306,4191,67
216,/home/yww/CAS^3/new_data_full_reduce/216/l,Macro,1,1310,1342,4191,32
216,/home/yww/CAS^3/new_data_full_reduce/216/l,Macro,1,1421,1465,4191,44
216,/home/yww/CAS^3/new_data_full_reduce/216/l,Macro,1,2094,2155,4191,61
216,/home/yww/CAS^3/new_data_full_reduce/216/l,Macro,1,2273,2341,4191,68
216,/home/yww/CAS^3/new_data_full_reduce/216/l,Macro,1,2637,2664,4191,27
216,/home/yww/CAS^3/new_data_full_reduce/216/l,Macro,1,2857,2929,4191,72
216,/home/yww/CAS^3/new_data_full_reduce/216/m,Macro,1,3,77,2891,74
216,/home/yww/CAS^3/new_data_full_reduce/216/m,Macro,1,148,210,2891,62
216,/home/yww/CAS^3/new_data_full_reduce/216/m,Macro,1,423,482,2891,59
216,/home/yww/CAS^3/new_data_full_reduce/216/m,Macro,1,589,615,2891,26
216,/home/yww/CAS^3/new_data_full_reduce/216/m,Macro,1,2611,2653,2891,42
216,/home/yww/CAS^3/new_data_full_reduce/216/m,Micro,2,622,637,2891,15
217,/home/yww/CAS^3/new_data_full_reduce/217/a,Macro,1,104,124,903,20
217,/home/yww/CAS^3/new_data_full_reduce/217/a,Macro,1,528,561,903,33
217,/home/yww/CAS^3/new_data_full_reduce/217/b,Macro,1,400,448,985,48
217,/home/yww/CAS^3/new_data_full_reduce/217/b,Macro,1,675,730,985,55
217,/home/yww/CAS^3/new_data_full_reduce/217/b,Macro,1,743,783,985,40
217,/home/yww/CAS^3/new_data_full_reduce/217/c,Macro,1,91,144,2790,53
217,/home/yww/CAS^3/new_data_full_reduce/217/c,Macro,1,1673,1713,2790,40
217,/home/yww/CAS^3/new_data_full_reduce/217/c,Macro,1,2200,2269,2790,69
217,/home/yww/CAS^3/new_data_full_reduce/217/d,Macro,1,107,137,3909,30
217,/home/yww/CAS^3/new_data_full_reduce/217/d,Macro,1,209,253,3909,44
217,/home/yww/CAS^3/new_data_full_reduce/217/d,Macro,1,373,463,3909,90
217,/home/yww/CAS^3/new_data_full_reduce/217/d,Macro,1,440,467,3909,27
217,/home/yww/CAS^3/new_data_full_reduce/217/d,Macro,1,521,554,3909,33
217,/home/yww/CAS^3/new_data_full_reduce/217/d,Macro,1,747,777,3909,30
217,/home/yww/CAS^3/new_data_full_reduce/217/d,Macro,1,2032,2060,3909,28
217,/home/yww/CAS^3/new_data_full_reduce/217/d,Macro,1,3094,3116,3909,22
217,/home/yww/CAS^3/new_data_full_reduce/217/d,Macro,1,3475,3506,3909,31
217,/home/yww/CAS^3/new_data_full_reduce/217/e,Macro,1,34,58,2587,24
217,/home/yww/CAS^3/new_data_full_reduce/217/e,Macro,1,140,203,2587,63
217,/home/yww/CAS^3/new_data_full_reduce/217/e,Macro,1,350,390,2587,40
217,/home/yww/CAS^3/new_data_full_reduce/217/e,Macro,1,1513,1598,2587,85
217,/home/yww/CAS^3/new_data_full_reduce/217/e,Macro,1,1647,1698,2587,51
217,/home/yww/CAS^3/new_data_full_reduce/217/g,Macro,1,43,73,2235,30
217,/home/yww/CAS^3/new_data_full_reduce/217/g,Macro,1,262,300,2235,38
217,/home/yww/CAS^3/new_data_full_reduce/217/g,Macro,1,547,589,2235,42
217,/home/yww/CAS^3/new_data_full_reduce/217/g,Macro,1,767,800,2235,33
217,/home/yww/CAS^3/new_data_full_reduce/217/g,Macro,1,918,958,2235,40
217,/home/yww/CAS^3/new_data_full_reduce/217/g,Macro,1,1155,1175,2235,20
217,/home/yww/CAS^3/new_data_full_reduce/217/g,Macro,1,1501,1528,2235,27
217,/home/yww/CAS^3/new_data_full_reduce/217/g,Macro,1,1885,1906,2235,21
217,/home/yww/CAS^3/new_data_full_reduce/217/h,Macro,1,1054,1096,2889,42
217,/home/yww/CAS^3/new_data_full_reduce/217/h,Macro,1,1743,1796,2889,53
217,/home/yww/CAS^3/new_data_full_reduce/217/h,Macro,1,2022,2065,2889,43
217,/home/yww/CAS^3/new_data_full_reduce/217/i,Macro,1,118,174,3552,56
217,/home/yww/CAS^3/new_data_full_reduce/217/i,Macro,1,268,296,3552,28
217,/home/yww/CAS^3/new_data_full_reduce/217/i,Macro,1,3157,3195,3552,38
217,/home/yww/CAS^3/new_data_full_reduce/217/k,Macro,1,29,53,2348,24
217,/home/yww/CAS^3/new_data_full_reduce/217/k,Macro,1,1136,1159,2348,23
217,/home/yww/CAS^3/new_data_full_reduce/217/l,Macro,1,1614,1633,3470,19
217,/home/yww/CAS^3/new_data_full_reduce/217/m,Macro,1,150,186,2496,36
217,/home/yww/CAS^3/new_data_full_reduce/217/m,Macro,1,429,460,2496,31
217,/home/yww/CAS^3/new_data_full_reduce/217/m,Macro,1,552,598,2496,46
218,/home/yww/CAS^3/new_data_full_reduce/218/i,Macro,1,416,439,3610,23
218,/home/yww/CAS^3/new_data_full_reduce/218/i,Macro,1,530,581,3610,51
